abby	ﺍﺏی
abell	ﺍﺏﻝ
abia	ﺍﺏیﺍ
abley	ﺍﺏﻝی
ackroyd	ﺍکﺭﻭیﺩ
acton	ﺍکﺕﻭﻥ
adelaide	ﺍﺩﻝﺍیﺩ
adnams	ﺍﺩﻥﺍﻡﺯ
adolph	ﺍﺩﻭﻝﻑ
aftab	ﺍﻑﺕﺍﺏ
agostini	ﺍگﻭﺱﺕیﻥی
aguero	ﺍگﻭیﺭﻭ
aiken	ﺍیکﻥ
aiman	ﺍیﻡﺍﻥ
aimee	ﺍیﻡی
aird	ﺍیﺭﺩ
akil	ﻉﻕیﻝ
alden	ﺍﻝﻥ
alexandros	ﺍﻝکﺱﺍﻥﺩﺭﻭﺯ
alibey	ﺍﻝیﺏی
alice	ﺍﻝیﺱ
aliya	ﻉﻝیﺍ
allegro	ﺍﻝگﺭﻭ
allerton	ﺍﻝﺭﺕﻥ
allsop	ﺍﻝﺱپ
alpert	ﺍﻝپﺭﺕ
alsworth	ﺍﻝثﻭﺭﺕ
alya	ﺍﻝیﺍ
amador	ﺍﻡﺍﺩﻭﺭ
amal	ﺍﻡﺍﻝ
amarnath	ﺍﻡﺍﺭﻥﺕ
america	ﺍﻡﺭیکﺍ
amery	ﺍﻡﺭی
amnon	ﺍﻡﻥﻭﻥ
amoroso	ﺍﻡﻭﺭﻭﺱﻭ
anathea	ﺍﻥﺍﺕی
andreaea	ﺍﻥﺩﺭییﺍ
andrei	ﺍﻥﺩﺭی
angeles	ﺍﻥﺝﻝﺱ
anspach	ﺍﻥﺱپﺍچ
antal	ﺍﻥﺕﺍﻝ
antone	ﺍﻥﺕﻭﻥ
antonis	ﺍﻥﺕﻭﻥیﺱ
aperson	ﺍپﺭﺱﻭﻥ
arch	ﺍﺭچ
archdale	ﺍچﺩﻝ
ardalich	ﺍﺭﺩﺍﻝیچ
arras	ﺍﺭﺍﺱ
arsenault	ﺍﺭﺱﻥﺍﻝﺕ
ashmore	ﺍﺵﻡﻭﺭ
ashworth	ﺍﺵﻭﺭث
ask	ﺍﺱک
assi	ﺍﺱی
astley	ﺍﺱﺕﻝی
athey	ﺍﺕی
attewell	ﺍﺕﻭیﻝ
attlee	ﺍﺕﺕﻝی
aubrey	ﺍﻭﺏﺭی
auker	ﺍﻭکﺭ
auldridge	ﺍﻭﻝﺩﺭیﺝ
austbanen	ﺍﻭﺱﺕﺏﺍﻥﻥ
avian	ﺍﻭیﺍﻥ
badami	ﺏﺩﻡی
baden	ﺏﺍﺩیﻥ
baefje	ﺏیﺝ
baffle	ﺏﺍﻑﻝ
bagga	ﺏﺍگﺍ
bain	ﺏیﻥ
balham	ﺏﺍﻝﻩﺍﻡ
balike	ﺏﺍﻝیک
bancroft	ﺏﺍﻥکﺭﺍﻑﺕ
baniya	ﺏﻥیﺍ
bankwalla	ﺏﺍﻥکﻭﺍﻝﺍ
bard	ﺏﺍﺭﺩ
bark	ﺏﺍﺭک
barnett	ﺏﺍﺭﻥﺕ
basilisk	ﺏﺍﺱیﻝیﺱک
basma	ﺏﺱﻡی
batchelder	ﺏچﻝﺭ
battan	ﺏﺍﺕﺍﻥ
battle	ﺏﺍﺕﻝ
batul	ﺏطﻭﻝ
beach	ﺏیچ
beale	ﺏیﻝ
bean	ﺏیﻥ
bearing	ﺏیﺭیﻥگ
beavis	ﺏیﻭیﺱ
beckingsale	ﺏکیﻥگﺱﺍﻝ
beedle	ﺏیﺩﻝ
beehive	ﺏیﻩیﻭ
belvin	ﺏﻝﻭیﻥ
bender	ﺏﻥﺩﺭ
bensen	ﺏﻥﺱﻥ
bentow	ﺏﻥﺕﻭ
bernadus	ﺏﺭﻥﺍﺩﻭﺱ
besam	ﺏﺱﺍﻡ
bethancourt	ﺏیﺕﺍﻥکﺭﺕ
beveridge	ﺏﻭﺭیﺝ
bible	ﺏیﺏﻝ
bieber	ﺏیﺏﺭ
bigo	ﺏیگﻭ
billington	ﺏیﻝﻥگﺕﻭﻥ
bines	ﺏیﻥﺱ
binoy	ﺏیﻥﻭی
bir	ﺏیﺭ
blackley	ﺏﻝکﻝی
blackman	ﺏﻝکﻡﻥ
blatta	ﺏﻝیﺕﺍ
block	ﺏﻝﺍک
bobby	ﺏﺍﺏی
bodenmiller	ﺏﻭﺩﻥﻡیﻝﺭ
boggs	ﺏﺍگﺯ
boivin	ﺏﻭیﻭﻥ
bomber	ﺏﻭﻡﺏﺭ
bop	ﺏﺍپ
border	ﺏﻭﺭﺩﺭ
borel	ﺏﻭﺭﻝ
borland	ﺏﺭﻝﻥﺩ
bottrell	ﺏﻭﺕﺭﻝ
bourgea	ﺏﻭﺭﺝیﺍ
bowyer	ﺏﻭیﺭ
boylan	ﺏﻭیﻝﻥ
bozhidar	ﺏﻭژیﺩﺍﺭ
branscombe	ﺏﺭﺍﻥﺱکﻭﻡﺏ
brater	ﺏﺭﺍﺕﺭ
bratina	ﺏﺭﺍﺕیﻥﺍ
brawn	ﺏﺭﺍﻭﻥ
brewer	ﺏﺭﻭﻭﺭ
brewery	ﺏﺭیﻭﺭی
bridgman	ﺏﺭیﺝﻡﻥ
brinkler	ﺏﺭﺍیﻥکﻝﺭ
brisbane	ﺏﺭیﺱﺏیﻥ
brook	ﺏﺭﻭک
brownfield	ﺏﺭﺍﻭﻥﻑیﻝﺩ
browning	ﺏﺭﺍﻭﻥیﻥگ
bubb	ﺏﺍﺏ
buchalter	ﺏﺍچﺍﻝﺕﺭ
bugay	ﺏﺍگﺍی
bum	ﺏﻭﻡ
bunn	ﺏﺍﻥ
burj	ﺏﺭﺝ
bursell	ﺏﻭﺭﺱﻝ
buxey	ﺏﻭکﺱی
byron	ﺏیﺭﻥ
byungtae	ﺏیﺍﻥگﺕﺍی
cacciola	کﺍکیﻭﻝﺍ
callanan	کﺍﻝﺍﻥﺍﻥ
camfield	کﻡﻑیﻝﺩ
canfield	کﺍﻥﻑیﻝﺩ
carangelo	کﺍﺭﺍﻥﺝﻝﻭ
carnerie	کﺍﺭﻥﺭی
casey	کیﺱی
cecil	ﺱﺱیﻝ
chancellor	چﻥﺱﻝﻭﺭ
channel	کﺍﻥﺍﻝ
charrick	چﺍﺭیک
chauveau	چﺍﻭﻭیﻭ
cheiltje	چیﻝﺕ
cheney	چﻥی
chiang	چیﺍﻥگ
child	چﺍیﻝﺩ
childs	چﺍیﻝﺩﺯ
chin	چیﻥ
chopin	چﺍپیﻥ
cichero	کیچﺭﻭ
cirilo	ﺱیﺭیﻝﻭ
claridge	کﻝﺍﺭیﺝ
claude	کﻝﺍﻭﺩی
clonfero	کﻝﻭﻥﻑﺭﻭ
codogno	کﻭﺩﻭگﻥﻭ
coenraedt	کﻭﻥﺭﺍﺕ
coghlan	کﻭگﻝﺍﻥ
colton	کﺍﻝﺕﻭﻥ
conduit	کﺍﻥﺩﻭییﺕ
connett	کﻭﻥﺕ
connor	کﺍﻥﺭ
coomber	کﻭﻡﺏﺭ
coppedge	کﻭپﺝ
corkum	کﻭﺭکﺍﻡ
cornwell	کﺭﻥﻭﻝ
corre	کﻭﺭ
couch	کﻭچ
cranswick	کﺭﺍﻥﺱﻭیک
creasey	کﺭیﺱی
creider	کﺭیﺩﺭ
crest	کﺭﺱﺕ
crevasses	کﺭیﻭﺍﺱﺯ
crispijn	کﺭیﺱپیﻥ
crown	کﺭﺍﻭﻥ
crutcher	کﺭﺍچﺭ
curson	کﺭﺱﻥ
cushman	کﺍﺵﻡﻥ
cutler	کﺍﺕﻝیﺭ
cynthia	ﺱیﻥﺕیﺍ
cyr	ﺱیﺭ
dais	ﺩﺍیﺱ
danco	ﺩﺍﻥکﻭ
dancy	ﺩﺍﻥﺱی
danenbarger	ﺩﺍﻥﻥﺏﺍﺭگﺭ
daniell	ﺩﺍﻥیﻝ
danih	ﺩﻥیﻩ
danis	ﺩﻥیﺱ
dare	ﺩیﺭ
darlington	ﺩﺍﺭﻝیﻥگﺕﻥ
dauber	ﺩﺍﻭﺏﺭ
daulton	ﺩﺍﻝﺕﻭﻥ
davie	ﺩیﻭی
davison	ﺩیﻭیﺱﻥ
dawkins	ﺩﺍﻭکیﻥﺯ
dehner	ﺩﻩﻥﺭ
demetriou	ﺩیﻡیﺕﺭیﻭ
denkewalter	ﺩﻥکﻭﺍﻝﺕﺭ
dervenis	ﺩﺭﻭﻥیﺱ
desle	ﺩﺱﻝ
desrosiers	ﺩﺱﺭﻭﺯیﺭﺯ
detweiler	ﺩﺕﻭیﻝﺭ
dewey	ﺩیﻭی
diamond	ﺩیﺍﻡﻭﻥﺩ
dilten	ﺩﻝﺕﻥ
doctors	ﺩﺍکﺕﺭﺯ
dodier	ﺩﺍﺩیﺭ
dogwatch	ﺩﺍگﻭﺍچ
doi	ﺩﻭی
dolan	ﺩﻭﻝﺍﻥ
donnelly	ﺩﺍﻥﻥﻝی
donovan	ﺩﺍﻥﺍﻭﺍﻥ
doren	ﺩﻭﺭﻥ
dorsey	ﺩﻭﺭﺱی
dovell	ﺩﻭﻭﻝ
dreamer	ﺩﺭیﻡﺭ
drosehn	ﺩﺭﻭﺯﻥ
drummond	ﺩﺭﻭﻡﺍﻥﺩ
drune	ﺩﺭﻭﻥی
duarte	ﺩﻭﺍﺭﺕﻩ
dubinin	ﺩﻭﺏیﻥیﻥ
dubridge	ﺩﻭﺏﺭیﺩﺝ
duckering	ﺩﺍکﺭیﻥگ
dueck	ﺩﻭﺍک
duk	ﺩﺍک
dundee	ﺩﺍﻥﺩی
dupree	ﺩﺍپﺭی
duroch	ﺩﻭﺭﻭچ
eads	ﺍیﺩﺱ
eales	ﺍیﻝﺯ
easter	ﺍیﺱﺕﺭ
eastick	ﺍیﺱﺕیک
eater	ﺍیﺕﺭ
ebbert	ﺍﺏﺭﺕ
ebdon	ﺍﺏﺩﻭﻥ
eddey	ﺍﺩی
egan	ﺍیگﺍﻥ
egmose	ﺍگﻡﻭﺯ
einke	ﺍیﻥکﻩ
eirik	ﺍیﺭیک
eisele	ﺍیﺯﻝ
elford	ﺍﻝﻑﻭﺭﺩ
elie	ﺍﻝی
elkan	ﺍﻝکﺍﻥ
elvers	ﺍﻝﻭﺭﺱ
emlen	ﺍﻡﻝﻥ
empereur	ﺍﻡپﺭﻭﺭ
emre	ﺍﻡﺭ
enos	ﺍﻥﻭﺱ
enyo	ﺍﻥییﻭ
eppert	ﺍیپﺭﺕ
erdmann	ﺍﺭﺩﻡﻥ
erich	ﺍﺭیچ
erin	ﺍﺭیﻥ
erskine	ﺍﺭﺱکﺍیﻥ
ewing	ﺍیﻭﺍیﻥگ
ezor	ﺍﺯﺭ
faber	ﻑیﺏﺭ
fac	ﻑک
fadl	ﻑﺍﺩﻝ
falco	ﻑﺍﻝکﻭ
farago	ﻑﺍﺭﺍگﻭ
farid	ﻑﺭیﺩ
farooq	ﻑﺍﺭﻭک
farrell	ﻑﺍﺭﻝ
faust	ﻑﺍﻭﺱﺕ
fawziyya	ﻑﺍﻭﺯیﺍ
fayette	ﻑﺍیﺕ
felder	ﻑﻝﺩﺭ
felices	ﻑﻝیﺱﺯ
fellini	ﻑﻝیﻥی
fennis	ﻑیﻥیﺱ
fenyes	ﻑﻥیﺱ
ferdig	ﻑﺭﺩیگ
fernandes	ﻑﺭﻥﺍﻥﺩﺱ
ferrari	ﻑﺭﺍﺭی
fertik	ﻑﺭﺕیک
fetra	ﻑﺕﺭﺍ
fiasconaro	ﻑیﺍﺱکﻭﻥﺍﺭﻭ
fidalgo	ﻑیﺩﺍﻝگﻭ
finan	ﻑیﻥﺍﻥ
firma	ﻑیﺭﻡﺍ
flame	ﻑﻝیﻡ
flemmer	ﻑﻝﻡﺭ
flinders	ﻑﻝیﻥﺩﺭﺯ
flores	ﻑﻝﻭﺭﺯ
fluckiger	ﻑﻝﺍکیگﺭ
fluur	ﻑﻝﻭﺭ
fongen	ﻑﻭﻥگﻥ
fontes	ﻑﺍﻥﺕﺱ
forget	ﻑﺭگﺕ
forrer	ﻑﻭﺭﺭ
forsblom	ﻑﻭﺭﺱﺏﻝﺍﻡ
forsyth	ﻑﻭﺭﺱﺍیﺕ
fosdal	ﻑﺱﺩﺍﻝ
fozzard	ﻑﻭﺯﺍﺭﺩ
fraenkel	ﻑﺭﺍﻥکﻝ
france	ﻑﺭﺍﻥﺱ
franco	ﻑﺭﺍﻥکﻭ
francois	ﻑﺭﻥﺱﻭیﺱ
francoys	ﻑﺭﺍﻥکﻭی
frederico	ﻑﺭﺩﺭیکﻭ
fredrick	ﻑﺭیﺩﺭیک
free	ﻑﺭی
freeto	ﻑﺭیﺕﻭ
friedman	ﻑﺭﺍیﺩﻡﻥ
fries	ﻑﺭیﺱ
frix	ﻑﺭیکﺱ
fuetterer	ﻑﻭﺕﺭﺭ
furtek	ﻑﺍﺭﺕک
galloway	گﻝﻭﻭی
ganatra	گﺍﻥﺍﺕﺭﺍ
ganti	گﺍﻥﺕی
gaskins	گﺱکیﻥﺯ
gasper	گﺍﺱپﺭ
gatz	گﺍﺕﺯ
gayda	گﺍیﺩﺍ
gaynell	گﺍیﻥﻝ
gell	ﺝﻝ
gentges	ﺝﻥﺕﺝﺱ
geoffl	ﺝﻭﻑﻝ
georgia	ﺝﻭﺭﺝیﺍ
germack	گﺭﻡﺍک
gersappe	گﺭﺱﺍپﻩ
gertrude	گﺭﺕﺭﻭﺩ
ghaliya	ﻕﻝیﺏﺍ
ghufran	ﻍﻑﺭﺍﻥ
gideon	گیﺩﻭﻥ
gilley	گیﻝی
gilpin	گیﻝپیﻥ
gitomer	گیﺕﻭﻡﺭ
glacier	گﻝﺍﺱییﺭ
gleason	گﻝیﺱﻭﻥ
glenns	گﻝیﻥﺯ
gnosis	گﻥﻭﺱیﺱ
goddijn	گﺍﺩیﺝﻥ
goderre	گﺩﺭ
godfroid	گﺍﺩﻑﺭﻭیﺩ
golder	گﻝﺩﺭ
golub	گﻝﻭﺏ
gonderzik	گﺍﻥﺩﺭﺯیک
gonna	گﻭﻥﻥﺍ
gonzales	گﻭﻥﺯﺍﻝﺱ
goodger	گﻭﻭﺩگﺭ
goodrum	گﻭﺩﺭﺍﻡ
gosling	گﺍﺱﻝیﻥگ
goulding	گﻭﻝﺩیﻥگ
gralian	گﺭﺍﻝیﻥ
gramsas	گﺭﺍﻡﺱﺱ
graw	گﺭﺍﻭ
greer	گﺭیﺭ
griffis	گﺭیﻑیﺱ
groat	گﺭﻭﺕ
grog	گﺭﺍگ
groovy	گﺭﻭﻭی
gruen	گﺭﻭیﻥ
guest	گﺱﺕ
guido	گﺍیﺩﻭ
gulf	گﻝﻑ
gummerus	گﺍﻡﺭﻭﺱ
gundlach	گﺍﻥﺩﻝچ
gurley	گﺭﻝی
hafer	ﻩﺍﻑﺭ
hageman	ﻩﺍگﻡﻥ
hagen	ﻩﺍگﻥ
hail	ﺡیﻝ
hajar	ﻩﺍﺝﺭ
halliburton	ﻩﺍﻝیﺏﺭﺕﻭﻥ
halm	ﻩﺍﻝﻡ
hanaa	ﻩﺍﻥﺍ
hanson	ﻩﺍﻥﺱﻭﻥ
hardiman	ﻩﺍﺭﺩیﻡﻥ
harding	ﻩﺍﺭﺩیﻥگ
hargroves	ﻩﺍﺭگﺭﺍﻭﺯ
haricken	ﻩﺭیکﻥ
harith	ﻩﺭیﺕ
haroun	ﻩﺭﻭﺱ
harrison	ﻩﺭیﺱﻭﻥ
hartel	ﻩﺍﺭﺕﻝ
hartlep	ﻩﺍﺭﺕﻝپ
haruhisa	ﻩﺍﺭﻭﻩیﺱﺍ
harvell	ﻩﺍﺭﻭﻝ
harvey	ﻩﺍﺭﻭی
hassall	ﻩﺍﺱﺍﻝ
hawks	ﻩﺍکﺱ
hawn	ﻩﺍﻭﻥ
heald	ﻩﻝﺩ
heaton	ﻩیﺕﻭﻥ
heerdegen	ﻩیﺭﺩگﻥ
heetan	ﻩیﺕﻥ
heidrich	ﻩیﺩﺭیﺵ
heigl	ﻩیگﻝ
heintz	ﻩیﻥﺕﺯ
helbling	ﻩﻝﺏﻝیﻥگ
hendee	ﻩﻥﺩی
hendrickje	ﻩﻥﺩﺭیکﺝﻩ
hendricus	ﻩﻥﺩﺭیکﺍﺱ
henriet	ﻩﻥﺭیﺕ
hensley	ﻩﻥﺱﻝی
herlindis	ﻩﺭﻝﺍیﻥﺩیﺯ
herrera	ﻩﺭﺭﺍ
heuser	ﻩیﻭﺯﺭ
hill	ﻩیﻝ
hince	ﻩیﻥﺱ
hirt	ﻩیﺭﺕ
hocdet	ﻩﺍکﺩﺕ
hodson	ﻩﻭﺩﺱﻭﻥ
hoffbeck	ﻩﺍﻑﺏک
holland	ﻩﻝﻥﺩ
holliday	ﻩﺍﻝیﺩی
hollyman	ﻩﺍﻝیﻡﻥ
holroyd	ﻩﻭﻝﺭﻭیﺩ
holy	ﻩﻝی
hook	ﻩﻭک
hooper	ﻩﻭپﺭ
hope	ﻩﻭپ
horgan	ﻩﻭﺭگﺍﻥ
hoskins	ﻩﺍﺱکیﻥﺯ
hotopp	ﻩﺍﺕﺍپ
houghtailing	ﻩﺍﻭگﺕﺍیﻝیﻥگ
hourihan	ﻩﻭﺭیﻩﺍﻥ
houser	ﻩﺍﻭﺱﺭ
hua	ﻩﻭﺍ
huckvale	ﻩﺍکﻭیﻝ
hugdahl	ﻩﺍگﺩﺍﻝ
huhtala	ﻩﺍﻩﺕﺍﻩﺍ
huizing	ﻩﺭﺍیﺯیﻥگ
hummock	ﻩﻭﻡﺍک
hunt	ﻩﺍﻥﺕ
huntington	ﻩﺍﻥﺕیﻥگﺕﻭﻥ
husik	ﻩﺍﺱیک
hutcheson	ﻩﺍﺕچﺱﻭﻥ
hutchins	ﻩﺍچیﻥﺯ
hvezda	ﻭﺯﺩﺍ
hyman	ﻩیﻡﻥ
ibar	ﺍیﺏﺍﺭ
ice	ﺍیﺱ
igoe	ﺍیگﻭ
ilan	ﺍیﻝﺍﻥ
ileen	ﺍیﻝیﻥ
imar	ﺍیﻡﺍﺭ
ingegneri	ﺍیﻥﺝﺝﻥﺭی
ingle	ﺍیﻥگﻝ
inner	ﺍیﻥﺭ
institut	ﺍﻥﺱﺕیﺕﻭ
iowa	ﺍیﻭﺍ
ireland	ﺍیﺭﻝﻥﺩ
isecke	ﺍیﺱک
isman	ﺍیﺯﻡﻥ
iunn	یﻭﻥ
jacomyntie	ﺝﺍکﻭﻡیﺕ
jamulla	ﺝﻡﻭﻝﺍ
javed	ﺝﺍﻭیﺩ
jeremias	ﺝﺭﻡیﺱ
jester	ﺝﺱﺕﺭ
jetsam	ﺝﺕﺱﺍﻡ
jezire	ﺝﺯیﺭﻩ
jian	ﺝیﺍﻥ
johanna	ﺝﻭﻩﺍﻥﺍ
johnny	ﺝﺍﻥی
jonas	ﺝﻭﻥﺍﺱ
jongtae	ﺝﺍﻥگﺕﺍیی
jory	ﺝﻭﺭی
josephus	ﺝﻭﺯﻑﻭﺱ
josie	ﺝﻭﺯیﻩ
jost	ﺝﺍﺱﺕ
jude	ﺝﺍﺩ
juhani	ﺝﻭﻩﺍﻥی
juliaantje	ﺝﻭﻝیﺍﻥﺕﻩ
justham	ﺝﺍﺱﺕﺍﻡ
justine	ﺝﺍﺱﺕیﻥ
kailasa	کیﺍﻝﺍﺱﺍ
kain	کیﻥ
kalemis	کﺍﻝﻡیﺱ
kalisiak	کﺍﻝیﺱیﺍک
kalliany	کﺍﻝیﺍﻥی
kalpak	کﺍﻝپﺍک
kamb	کﺍﻡﺏ
kamens	کﺍﻡﻥﺱ
kamerud	کﺍﻡﺭﻭﺩ
kamlish	کﺍﻡﻝیﺵ
kandi	کﺍﻥﺩی
kang	کﺍﻥگ
kannan	کﺍﻥﺍﻥ
kao	کیﻭ
kaplenk	کﺍپﻝیﻥک
kapoor	کﺍپﻭﺭ
kara	کﺍﺭﺍ
karakash	کﺍﺭکﺍﺵ
karasu	کﺍﺭﺍﺱﻭ
kasai	کﺱﺍی
kasat	کﺍﺱﺍﺕ
kassirer	کﺍﺯیﺭﺭ
kast	کﺱﺕ
kastein	کﺍﺱﺕیﻥ
katryntje	کﺍﺕﺭیﻥﺕﺝﻩ
katwala	کﺍﺕﻭﺍﻝﺍ
kazmaier	کﺍﺯﻡﺍیﺭ
kazuhiro	کﺍﺯﻭﻩیﺭﻭ
kazunori	کﺍﺯﻭﻥﻭﺯی
keele	کیﻝ
kehle	کﻝ
keidra	کیﺩﺭﺍ
keir	کیﺭ
kellar	کﻝﺍﺭ
kellman	کﻝﻡﻥ
kemp	کﻡپ
kendi	کﻥﺩی
keng	کﻥگ
kenn	کﻥ
keppel	کپﻝ
kerwood	کﺭﻭﻭﺩ
ketan	کﺕﺍﻥ
kheong	کﻭﺍﻥگ
kibler	کیﺏﻝﺭ
kiely	کیﻝی
kimberly	کیﻡﺏﺭﻝی
kinard	کیﻥﺍﺭﺩ
kinchen	کیﻥچﻥ
kinkade	کیﻥکیﺩ
kinnersley	کیﻥﺭﺱﻝی
kirk	کیﺭک
klawiter	کﻝﺍﻭیﺕﺭ
klein	کﻝیﻥ
kloubek	کﻝﻭﺏک
kloukinas	کﻝﻭکیﻥﺍﺱ
knapp	ﻥپ
knepper	ﻥپﺭ
knippenberg	ﻥیپﻥﺏﺭگ
kolichala	کﻭﻝیچﺍﻝﺍ
konestabo	کﺍﻥﺱﺕﺍﺏﻭ
kono	کﻭﻥﻭ
kornele	کﻭﺭﻥﻝﻩ
kortright	کﻭﺭﺕﺭﺍیﺕ
kosenko	کﻭﺱﻥکﻭ
kosinski	کﺍﺱیﻥﺱکی
koslov	کﻭﺱﻝﻭ
kosten	کﻭﺱﺕﻥ
kovalcik	کﻭﺍﻝﺱیک
kowitt	کﻭیﺕ
kudlacek	کﺍﺩﻝﺍﺱک
kuldell	کﺍﻝﺩﻝ
kulesh	کﻭﻝﺵ
kunst	کﺍﻥﺕ
kuper	کﻭپﺭ
kurger	کﺭگﺭ
kurilla	کﻭﺭیﻝﺍ
kurt	کﺍﺭﺕ
laakso	ﻝﺍکﺱﻭ
ladasky	ﻝﺍﺩﺍﺱکی
lade	ﻝیﺩ
laird	ﻝﺍیﺭﺩ
landers	ﻝﺍﻥﺩﺭﺱ
landrum	ﻝﺍﻥﺩﺭﻭﻡ
langdon	ﻝﺍﻥگﺩﻭﻥ
lange	ﻝﺍﻥﺝ
lantlosamade	ﻝﺍﻥﺕﻝﻭﺱﺍﻡﺍﺩ
larocque	ﻝﺍﺭﻭکﻭیﻩ
larson	ﻝﺍﺭﺱﻭﻥ
lascari	ﻝﺍﺱکﺍﺭی
lawrence	ﻝﺍﺭﻥﺱ
leas	ﻝیﺱ
lebrun	ﻝیﺏﺭﻥ
lefaive	ﻝیﻑﺍیﻭ
leffler	ﻝﻑﻝﺭ
leibowitz	ﻝیﺏﻭیﺕﺯ
leila	ﻝیﻝﺍ
leonard	ﻝیﻭﻥﺍﺭﺩ
lesiak	ﻝﺱیﺍک
lessard	ﻝﺱﺍﺭﺩ
levavy	ﻝیﻭیﻭی
lie	ﻝی
liebchen	ﻝیﺏچﻥ
lim	ﻝیﻡ
lin	ﻝیﻥ
linehan	ﻝیﻥﻩﺍﻥ
lippard	ﻝیپﺍﺭﺩ
liren	ﻝیﺭﻥ
littleton	ﻝیﺕﻝﺕﻭﻥ
loats	ﻝﻭﺍﺕﺱ
lobb	ﻝﺍﺏ
locker	ﻝﺍکﺭ
lofstrom	ﻝﻭﻑﺱﺕﺭﻭﻡ
loke	ﻝﻭک
lotempio	ﻝﻭﺕﻡپیﻭ
lovitt	ﻝﺍﻭیﺕ
lucas	ﻝﻭکﺍﺱ
ludorf	ﻝﻭﺩﻭﺭﻑ
luke	ﻝﻭک
luntz	ﻝﺍﻥﺕﺯ
lunz	ﻝﻭﻥﺯ
luxton	ﻝﻭکﺱﺕﻭﻥ
lydea	ﻝیﺩﺍ
lylah	ﻝیﻝﺍ
mach	ﻡﺍخ
macmillan	ﻡکﻡیﻝﺍﻥ
macris	ﻡکﺭیﺱ
madden	ﻡﺍﺩﻥ
madigan	ﻡﺍﺩیگﺍﻥ
mads	ﻡﺩﺱ
magne	ﻡگﻥﻩ
magruder	ﻡﺍگﺭﻭﺩﺭ
maltin	ﻡﺍﻝﺕیﻥ
mama	ﻡﺍﻡﺍ
mancus	ﻡﺍﻥکﻭﺱ
mandy	ﻡﻥﺩی
manetta	ﻡﺍﻥﺕﺍ
mangin	ﻡﺍﻥگیﻥ
mangus	ﻡﻥگﺱ
manjeet	ﻡﺍﻥﺝیﺕ
mannix	ﻡﺍﻥیکﺱ
manolo	ﻡﺍﻥﻭﻝی
mantle	ﻡﻥﺕﻝ
mar	ﻡﺍﺭ
marani	ﻡﺍﺭﺍﻥی
marcos	ﻡﺍﺭکﻭﺱ
marcus	ﻡﺍﺭکییﻭﺱ
mariano	ﻡﺍﺭیﺍﻥﺍ
markham	ﻡﺍﺭخﺍﻡ
marla	ﻡﺍﺭﻝﺍ
marquette	ﻡﺍﺭکﻭیﺕ
marritje	ﻡﺍﺭیﺕﺝی
martell	ﻡﺍﺭﺕﻝ
martino	ﻡﺍﺭﺕیﻥﻭ
martland	ﻡﺍﺭﺕﻝﻥﺩ
marx	ﻡﺍﺭکﺱ
marxen	ﻡﺍﺭکﺱﻥ
masao	ﻡﺍﺱﺍیﻭ
mascari	ﻡﺍﺱکﺍﺭی
mashburn	ﻡﺵﺏﺍﺭﻥ
masselli	ﻡﺍﺱﻝﻝی
maximilian	ﻡﺍکﺱیﻡیﻝیﺍﻥ
mccracken	ﻡککﺭکﻥ
mcfarland	ﻡکﻑﺍﺭﻝﻥﺩ
mcgavin	ﻡکگﺍﻭیﻥ
mcguirk	ﻡکگﻭیﺭک
mclean	ﻡکﻝیﻥ
mcmahan	ﻡکﻡﺍﻩﺍﻥ
meagher	ﻡیگﺭ
meechan	ﻡیچﺍﻥ
mejia	ﻡﺝیﺍ
menhardt	ﻡﻥﻩﺍﺭﺕ
merolle	ﻡیﺭﻭﻝ
merricks	ﻡﺭیکﺱ
mertens	ﻡﺭﺕﻥﺯ
mesa	ﻡﺱﺍ
messer	ﻡﺱﺭ
micha	ﻡیچﺍ
miehe	ﻡییﻩ
mier	ﻡیﺭ
milacic	ﻡیﻝﺍﺱیﺱ
millan	ﻡیﻝﺍﻥ
millett	ﻡیﻝﺕ
milne	ﻡﺍیﻝﻥ
milo	ﻡیﻝﻭ
milos	ﻡیﻝﻭﺱ
milton	ﻡیﻝﺕﻥ
milward	ﻡیﻝﻭﺍﺭﺩ
mineral	ﻡیﻥﺭﺍﻝ
mistry	ﻡیﺱﺕﺭی
mithal	ﻡیﺕﺍﻝ
monkey	ﻡﺍﻥکی
moras	ﻡﻭﺭﺍﺱ
morrell	ﻡﻭﺭﻝ
morton	ﻡﻭﺭﺕﺍﻥ
mounzer	ﻡﻥﺯﺭ
mozina	ﻡﻭﺯیﻥﺍ
muessig	ﻡﻭﺱیگ
muno	ﻡﺍﻥﻭ
mutt	ﻡﺍﺕ
myth	ﻡﺍیﺕ
nabatiye	ﻥﺏﺍﺕﺍی
nagy	ﻥﺍگی
najiyah	ﻥﺝیﻩ
nam	ﻥﺍﻡ
napolitano	ﻥﺍپﻭﻝیﺕﺍﻥﻭ
napton	ﻥﺍپﺕﻭﻥ
nashida	ﻥﺵیﺩﺍ
nasira	ﻥﺱیﺭﺍ
nau	ﻥﺍﻭ
naunton	ﻥﺍﻥﺕﻭﻥ
nazahah	ﻥﺯﺍﻩﺍ
nefedow	ﻥﻑﺩﻭ
nevejans	ﻥﻭﺝﻥﺍﻥﺱ
nevel	ﻥﻭﻝ
newark	ﻥیﻭﺍﺭک
nickey	ﻥیکی
nicolas	ﻥیکﻭﻝﺍﺱ
nicolaus	ﻥیکﻝﺍﺱ
nid	ﻥیﺩ
niemi	ﻥیﻡی
niermann	ﻥﺍیﺭﻡﻥ
nigg	ﻥیگ
nihalani	ﻥیﻩﺍﻝﺍﻥی
niles	ﻥﺍیﻝﺯ
nilse	ﻥیﻝﺱ
nin	ﻥیﻥ
nino	ﻥیﻥﻭ
ninoys	ﻥیﻥﻭیﺱ
noble	ﻥﻭﺏﻝ
nuding	ﻥﻭﺩیﻥگ
nuri	ﻥﻭﺭﺍ
olin	ﺍﻝیﻥ
oliveira	ﺍﻝیﻭﺭیﺍ
oregan	ﺍﺭگﺍﻥ
orford	ﺍﺭﻑﻭﺭﺩ
ortiz	ﺍﻭﺭﺕیﺯ
orue	ﺍﻭﺭﻭ
osowski	ﺍﺱﻭﺱکی
ott	ﺍﺕ
ozgur	ﺍﻭﺯگﻭﺭ
paks	پﺍکﺱ
pancras	پﺍﻥکﺭﺱ
pandya	پﻥﺩیﺍ
panici	پﺍﻥیﺱی
pannon	پﺍﻥﻭﻥ
pape	پیپ
parkin	پﺍﺭکیﻥ
parks	پﺍﺭکﺯ
paynter	پیﻥﺕﺭ
peabody	پیﺏﺍﺩی
peil	پیﻝ
peter	پﺕﺭ
petren	پﺕﺭﻥ
petronella	پﺕﺭﻭﻥﻝﺍ
pickel	پیکﻝ
pieck	پیک
pilato	پیﻝﺍﺕﻭ
pillars	پیﻝﺍﺭﺯ
pindar	پیﻥﺩﺍﺭ
pinette	پیﻥﺕﻩ
ping	پیﻥگ
pinson	پیﻥﺱﻥ
pohl	پﻭﻩﻝ
polson	پﻭﻝﺱﻥ
poore	پﻭﺭ
porterfield	پﻭﺭﺕﺭﻑیﻝﺩ
potts	پﺍﺕﺱ
pram	پﺭﺍﻡ
praveen	پﺭﺍﻭیﻥ
primeau	پﺭیﻡﻭ
priya	پﺭیﺍ
projet	پﺭﻭﺝﺕ
promontory	پﺭﻭﻡﻭﻥﺕﻭﺭی
provo	پﺭﻭﻭ
pui	پییﻭ
purahoo	پﻭﺭﺍﻩﻭ
qamar	کﻡﺭ
quainton	کﻭﺍیﻥﺕﻭﻥ
rabel	ﺭﺍﺏﻝ
rafalski	ﺭﺍﻑﺍﻝﺱکی
rafferty	ﺭﺍﻑﺭﺕی
rami	ﺭﺍﻡی
ramthun	ﺭﺍﻡﺕﺍﻥ
raverdy	ﺭﺍﻭﺭﺩی
rawdah	ﺭﺩﺍ
rawlings	ﺭﺍیﻭﻝیﻥگﺯ
rayner	ﺭﺍیﻥﺭ
rebholz	ﺭﺏﻩﻭﻝﺯ
reckeweg	ﺭکﻭگ
reiland	ﺭیﻝﻥﺩ
reodique	ﺭیﺩیگ
resyntje	ﺭﺯﻥﺕﺝی
reyden	ﺭیﺩﻥ
rheni	ﻩﻥی
riemers	ﺭیﻡﺭﺱ
rienks	ﺭییﻥکﺱ
rigler	ﺭیگﻝﺭ
risel	ﺭﺍیﺱﻝ
ritchie	ﺭیﺕچی
roar	ﺭﻭﺭ
robijn	ﺭﺍﺏیﺝﻥ
roderick	ﺭﺩﺭیک
rodriguez	ﺭﻭﺩﺭیگﺯ
roepke	ﺭﻭپکﻩ
rondane	ﺭﻭﻥﺩیﻥ
rontgen	ﺭﺍﻥﺕگﻥ
rood	ﺭﻭﺩ
rooks	ﺭﻭکﺯ
rosa	ﺭﻭﺱﺍ
rosen	ﺭﻭﺯﻥ
rosenjack	ﺭﻭﺯﻥﺝک
rossman	ﺭﺍﺱﻡﻥ
rotiala	ﺭﻭﺱیﺍﻝﺍ
rowett	ﺭﻭﺕ
royse	ﺭﻭیﺱ
rudewig	ﺭﺍﺩﻭیگ
rueter	ﺭﻭﺍﺕﺭ
rukan	ﺭﻭکﻥ
russell	ﺭﻭﺱﻝ
rutks	ﺭﺍﺕکﺱ
ryden	ﺭﺍیﺩﻥ
ryder	ﺭیﺩﺭ
rysling	ﺭیﺱﻝیﻥگ
sabine	ﺱﺏﺍیﻥ
sabra	ﺹﺏﺭﺍ
sadah	ﺱﺩﺍﻩ
sage	ﺱیگ
saint	ﺱﻥﺕ
salzenberg	ﺱﺍﻝﺯﻥﺏﺭگ
samah	ﺱﻡﺍ
sambolec	ﺱﺍﻡﺏﻭﻝیک
samiyah	ﺱﻡیﺍﻩ
samuel	ﺱﺍﻡﻭیﻝ
sandie	ﺱﻥﺩی
sandlin	ﺱﻥﺩﻝیﻥ
sandvik	ﺱﻥﺩﻭیک
sather	ﺱﺍﺕﺭ
sawchuk	ﺱﺍچک
sayre	ﺱیﺭ
scribbling	ﺍﺱکﺭیﺏﻝیﻥگ
seales	ﺱیﻝﺯ
seaver	ﺱیﻭﺭ
seely	ﺱیﻝی
sekora	ﺱیکﺍﺭﻭ
selim	ﺱﻝیﻡ
semir	ﺱﻡیﺭ
sepinwall	ﺱپیﻥﻭﺍﻝ
sercan	ﺱﺭکﺍﻥ
sethuraman	ﺱﺕﻭﺭﺍﻡﺍﻥ
shadiyah	ﺵﺍﺩیﺍﻩ
shamaliyah	ﺵﻡﺍﻝیﺍﻩ
shamas	ﺵﺍﻡﺍﺱ
shari	ﺵﺭی
sheckman	ﺵکﻡﺍﻥ
sheeran	ﺵیﺭﺍﻥ
sheffield	ﺵﻑیﻝﺩ
sheldon	ﺵیﻝﺩﻥ
sheng	ﺵﻥگ
shenghun	ﺵﻥﻕﺍﻥ
shimayah	ﺵیﻡﺍیﻩ
shlaes	ﺵﻝﺍیﺯ
shoshani	ﺵﺵﺍﻥی
siegel	ﺱیگﻝ
siggs	ﺱیگﺱ
sigman	ﺱیگﻡﻥ
silbermann	ﺱیﻝﺏﺭﻡﺍﻥ
silver	ﺱیﻝﻭﺭ
simard	ﺱیﻡﺍﺭﺩ
simcik	ﺱیﻡﺱیک
simms	ﺱیﻡﺱ
sindre	ﺱیﻥﺩﺭﻩ
skerry	ﺍﺱکﺭی
skiles	ﺍﺱکیﻝﺱ
skippy	ﺍﺱکیپی
slabotnen	ﺍﺱﻝﺏﻭﺕﻥﻥ
slater	ﺍﺱﻝﺍﺕﺭ
sledge	ﺱﻝﺝ
slippery	ﺱﻝیپﺭی
slope	ﺍﺱﻝﻭپ
slotkin	ﺍﺱﻝﺍﺕکیﻥ
smadja	ﺍﺱﻡﺍﺩﺝ
smiths	ﺍﺱﻡیﺕﺯ
smythe	ﺍﺱﻡﺍیﺕ
snail	ﺍﺱﻥیﻝ
sobhan	ﺱﺏﺡﺍﻥ
sogen	ﺱﻭگﻥ
sonja	ﺱﻭﻥﺝﺍ
sor	ﺱﻭﺭ
sorensen	ﺱﻭﺭﻥﺱﻥ
sotilas	ﺱﻭﻝیﺕﺍﺱ
soun	ﺱﻭﻥ
spatafora	ﺍﺱپﺍﺕﺍﻑﻭﺭﺍ
speer	ﺍﺱپیﺭ
spies	ﺍﺱپﺍیﺯ
sporay	ﺍﺱپﻭﺭی
stanford	ﺍﺱﺕﻥﻑﺭﺩ
stansell	ﺍﺱﺕﻥﺱﻝ
start	ﺍﺱﺕﺍﺭﺕ
still	ﺍﺱﺕیﻝ
stoler	ﺍﺱﺕﻝﺭ
stothers	ﺍﺱﺕﺍﺕﺭﺯ
streater	ﺱﺕﺭیﺕﺭ
struckman	ﺍﺱﺕﺭﺍکﻡﻥ
strydom	ﺍﺱﺕﺭیﺩﻡ
sunny	ﺱﺍﻥی
sup	ﺱﺍپ
susanne	ﺱﻭﺯﺍﻥﻩ
suwayda	ﺱﻭﺍیﺩﺍ
swa	ﺱﻭﺍ
sytje	ﺱﺍیﺕﺝ
taka	ﺕﺍکﺍ
takiyah	ﺕکیﻩ
talboys	ﺕﺍﻝﺏﻭیﺯ
tallen	ﺕﺍﻝﻥ
tamas	ﺕﺍﻡﺍﺱ
taplin	ﺕﺍپﻝیﻥ
tarr	ﺕﺍﺭ
tatari	ﺕﺍﺕﺍﺭی
taterway	ﺕﺍﺕﺭﻭی
teche	ﺕک
tenaya	ﺕﻥﺍیﺍ
terrence	ﺕﺭﻥﺱﻩ
tess	ﺕﺱ
thara	ﺕﺍﺭﺍ
thornley	ﺕﻭﺭﻥﻝی
thorpe	ﺕﻭﺭپ
throop	ﺕﺭﻭپ
thurman	ﺕﻭﺭﻡﻥ
thurn	ﺕﺍﺭﻥ
tina	ﺕیﻥﺍ
tindall	ﺕیﻥﺩﺍﻝ
tipul	ﺕیپﺍﻝ
tomi	ﺕﻭﻡی
tooke	ﺕﻭک
tooley	ﺕﻭﻝی
toon	ﺕﻭﻥ
topic	ﺕﺍپیک
trickett	ﺕﺭیکﺕ
trinkle	ﺕﺭیﻥکﻝ
trown	ﺕﺭﺍﻭﻥ
true	ﺕﺭﻭ
truesdale	ﺕﺭﻭیﺱﺩیﻝ
trumbo	ﺕﺭﻭﻡﺏﻭ
tullis	ﺕﺍﻝیﺱ
turco	ﺕﻭﺭکﻭ
tusing	ﺕﻭﺱیﻥگ
tyson	ﺕﺍیﺱﻥ
ubaid	ﻉﺏیﺩ
user	یﻭﺯﺭ
vail	ﻭیﻝ
vancuren	ﻭﺍﻥکﻭﺭﻥ
vanschoonhoven	ﻭﺍﻥﺱچﻭﻥﻩﻭﻥ
varlow	ﻭﺭﻝﻭ
ved	ﻭﺩ
velasco	ﻭیﻝﺍﺱکﻭ
verity	ﻭﺭیﺕی
vestli	ﻭﺱﺕﻝی
vik	ﻭیک
vila	ﻭیﻝﺍ
viles	ﻭیﻝﺯ
volodin	ﻭﻝﻭﺩیﻥ
vos	ﻭﺱ
vowles	ﻭﻭﻝﺯ
vrouwtje	ﺭﻭﻭﺕ
walton	ﻭﺍﻝﺕﻭﻥ
wasson	ﻭﺍﺱﻭﻥ
weaver	ﻭیﻭﺭ
webb	ﻭﺏ
wegner	ﻭگﻥﺭ
welter	ﻭﻝﺕﺭ
weninger	ﻭﻥیﻥگﺭ
wesleyan	ﻭﺱﻝیﺍﻥ
wiewer	ﻭیﻭﻭﺭ
wigley	ﻭیگﻝی
wilkerson	ﻭیﻝکﺭﺱﻭﻥ
willats	ﻭیﻝﺍﺕﺯ
willey	ﻭیﻝی
willner	ﻭیﻝﻥﺭ
willour	ﻭﻝﺭ
willy	ﻭیﻝی
wook	ﻭﻭک
woollard	ﻭﻭﻝﺍﺭﺩ
worden	ﻭﻭﺭﺩﻥ
wust	ﻭﺍﺱﺕ
yagla	یﺍگﻝﺍ
yangi	یﺍﻥگی
yanson	یﺍﻥﺱﻭﻥ
york	یﻭﺭک
yumn	یﻭﻥ
zaira	ﺯﺍیﺭ
zangerl	ﺯﺍﻥگﺭﻝ
zara	ﺯﺍﺭﺍ
zeke	ﺯک
zemanek	ﺯﻡﺍﻥک
zocca	ﺯﻭکﺍ
zolmer	ﺯﻭﻝﻡﺭ
zurink	ﺯﺭیﻥک
zygmunt	ﺯیگﻡﻭﻥﺕ
