aabar	ابر
aahie	اهاى
aali	عالى
aaliyah	عالىه
aaltruide	التروىد
aamina	انىما
aaron	ارن
aba	ابا
abbey	ابى
abbot	ابوت
abbotsmith	ابوتسمىت
abbott	ابت
abby	ابى
abcher	ابچر
abdalrahman	عبدالرحمان
abdul	عبدل
abdulaziz	عبدوالعزىز
abdulrahman	عبدالرحمن
abe	ابه
abel	ابىل
abele	ابله
abell	ابل
abella	ابلا
abeltje	ابلتج
abend	ابند
abercrombie	ابركرومبى
abery	ابرى
abhay	ابهاى
abia	ابىا
abiab	ابىاب
abiad	ابىاد
abilock	ابىلاك
ablation	ابلىشن
abley	ابلى
abner	ابنر
abolin	ابولىن
abou	ابو
abraham	ابراهام
abram	ابرام
abramson	ابرامسون
abrupt	ابراپت
abstract	ابستركت
abtine	ابتىن
abudhabi	عبودهابى
academy	اكادمى
accapadi	اكاپادى
access	اكسس
ace	اىس
acee	اكى
acevedo	اكودو
achernar	اچرنار
achilles	اچىلس
ack	اك
ackley	اكلى
ackroyd	اكروىد
acmena	اكمنا
acosta	اكوستا
acox	اكوكس
active	اكتىو
acton	اكتون
acuna	اكونا
acuner	اكونر
adalma	ادلما
adam	ادام
adamo	ادامو
adan	ادان
adana	ادانا
adcock	ادكوك
addicks	ادىكس
addington	ادىنگتون
addis	ادىس
addy	ادى
ade	اده
adel	ادل
adela	ادلا
adelaide	ادلاىد
adelardo	ادلاردو
adelheid	الدهاىد
adelson	ادلسون
adgeringelant	ادگرىنگلند
adik	ادىك
adil	ادىل
adina	ادىنا
adisak	ادىساك
adit	ادىت
adkins	ادكىنز
adler	ادلر
admiralen	ادمىرالن
admirals	ادمىرالز
adolfsson	ادولفسون
adolph	ادولف
adonis	ادونىس
adri	ادرى
adriaen	ادرىان
adriana	ادرىانا
adriance	ادرىنس
adriane	ادرىن
adrie	ادرى
adrienne	ادرىنى
adsett	ادت
adusumalli	ادوسومالى
adventure	ادونچر
aechtie	اكتى
aeltje	االتج
aernoudt	ارنوت
aetje	اتجه
afa	افا
afif	افىف
afioun	افىون
afou	افو
afra	افرا
aftab	افتاب
afzal	افزال
against	اگىنست
agali	اگالى
aganovic	اگنوىك
agate	اگاتى
ageno	اگنو
agent	اجنت
aggelos	اجلوس
agndie	اگندى
agopian	اگپىان
agostinelli	اگوستىنلى
agostini	اگوستىنى
agoyo	اگوىو
agren	اگرن
aguero	اگوىرو
agullo	اگولو
ahern	اهرن
ahlstrom	الستروم
aibel	اىبل
aida	اىدا
aidid	اىدىد
aiesha	اشىا
aiken	اىكن
aileen	اىلىن
ailsa	اىلسا
aim	اىم
aiman	اىمان
aimee	اىمى
ain	عىن
ainissa	اىنىسا
ainley	اىنلى
aint	اىنت
air	اىر
airay	ارىا
aird	اىرد
airdo	اىردو
airlines	اىرلاىنز
airoun	اىرون
aisenstat	اىسنستات
aissama	اىساما
aitcho	اىتچو
aitken	اىتكن
aitsen	اىتسن
ajay	اجاى
aka	اكا
akademik	اكادمىك
akdag	اكداگ
akeem	اكىم
akemi	اكمى
aki	اكى
akihiko	اكىهىكو
akil	اكىل
akilah	عقىلا
akilesh	اكىلش
akin	اكىن
akitomo	اكىتومو
akl	اكل
akman	اكمان
aksu	اكسو
alaaldin	علادىن
alagesan	الگسان
alain	الاىن
alaisdair	الاىسدىر
alamode	المود
alana	الانا
alapati	الاپاتى
alaqabah	الكواب
alber	البر
albert	البرت
albertini	البرتىنى
albinger	البىنگر
albright	البراىت
alcmere	الكمر
alden	الن
alder	الدر
aldrich	الدرىچ
alegado	الگادو
alelyunas	الىلىوناس
alesandro	السندرو
aleser	السر
alessandri	الساندرى
alex	الكس
alexander	الكسندر
alexandros	الكساندروز
alexiou	الكسىو
alf	الف
alfaro	الفارو
alfonso	الفانسو
alford	الفورد
alfors	الفرس
alfred	الفرد
alfredo	الفردو
algie	الگى
alhudud	الهداد
alia	علىا
alias	الىس
alibey	الىبى
alice	الىس
alicia	الىسىا
alien	الىن
alim	علىم
alima	علىما
alington	الىنگتون
alisa	الىزا
alistair	الىستىر
aliya	علىا
alkabeer	الكبر
alkerton	الكرتون
alkhazna	الخزنا
all	ال
alladhiqiyah	اللاهىگىاه
allard	الارد
allbery	البرى
allcock	الكوك
allcor	الكور
allden	الدن
allee	على
allegro	الگرو
allen	الن
allender	الندر
allerton	الرتون
alley	الى
allie	الى
allison	الىسن
allport	الپورت
allred	الرد
allshouse	الشوز
allsop	الساپ
allsopp	الساپ
allums	الامز
allyson	الىسون
allyz	الىز
alm	الم
almas	الماس
almeroth	المروت
almgren	المگرن
almintaqah	المىنتاگاه
almirall	المىرال
almqvist	المكوىست
alnoor	النور
alok	الوك
alpen	الپن
alpert	الپرت
alpha	الفا
alridge	الرىج
alsop	السپ
alsworth	السورث
altair	الطىر
alto	التو
alukal	الوكال
alva	الوا
alvarez	الوارز
alvaro	الوارو
alvarus	الواروس
alves	الوز
alvin	الوىن
alwan	الوان
alwis	الوىس
alwyn	الوىن
alya	علىا
alyosha	الوشا
alyssa	الىسا
alyx	الىكس
alzena	الزنا
ama	اما
amador	امادور
amand	اماند
amani	امانى
amano	امانو
amara	امارا
amaral	امارال
amardeo	اماردىو
amarit	امارىت
amarnath	امارنت
amberle	امبرلى
ambler	امبلر
ambrosio	امبروسىو
ambrosius	امبروسوس
ambush	امبوش
amedeo	امدىو
amelia	املىا
america	امرىكا
american	امرىكن
amerikan	امرىكن
amery	امرى
amethysta	امتىستا
amezquita	امىزوتا
ami	امى
amicus	امىكوس
amie	امىه
amihai	امىهاى
amina	امىنا
amiot	امىوت
amira	امىرا
amit	امىت
amitava	امىتاوا
amlak	املك
amna	امنا
amnon	امنون
amoroso	اموروسو
amory	امورى
amos	اموس
ampon	امپن
ampte	امت
amritha	امرىتا
amshey	امشى
amstadt	امستات
amster	امستر
amy	امى
amyot	امىوت
anagram	اناگرام
analog	انالوگ
anand	اناند
ananda	اناندا
anant	انانت
anantha	انانسا
anas	اناس
anastacia	اناستاسىا
anathea	اناتى
anatoly	اناتولى
anbar	عنبر
anbu	انبو
anchi	انچى
anckorn	انكورن
and	اند
ande	اند
andenes	اندنس
ander	اندر
anderberg	اندربرگ
andersen	اندرسن
anderson	اندرسون
andolsen	اندولسن
andr	اندر
andra	اندرا
andrea	اندرىا
andreaea	اندرىىا
andreas	اندرىاس
andreasen	اندرسن
andree	اندرى
andreessen	اندرىسن
andrei	اندرى
andres	اندرىس
andress	اندرس
andrews	اندرىوز
andries	اندرىز
andris	اندرىس
andrus	اندروس
angelini	انجىلىنى
angelis	انجلىس
angelo	انجلو
anghe	انق
angle	انجل
angles	انگلس
anglesea	انجلىسىا
angulo	انگولو
anhold	انهلد
anilane	اناىلىن
anisa	انسىه
ankeney	انكنى
anker	انكر
anne	انه
annette	انته
annexstad	انكستاد
annius	انىوس
anniversary	انىورسرى
anon	انون
anoop	انوپ
anoosh	انوش
anscomb	انسكامب
ansell	انسل
anselm	انسلم
anselmo	انسلمو
ansley	انسلى
anspach	انسپاچ
anssi	انسى
antal	انتال
antanaitis	انتاناىتىس
antaramian	انتارامىان
antenna	انتنا
antero	انترو
antevs	انتوس
anthea	انسى
anthistle	انتىستله
anthony	انتونى
antila	انتىلا
antipodes	انتىپدس
antone	انتون
antoni	انتونى
antonio	انتونىو
antonis	انتونىس
antonius	انتونىس
antonoglou	انتونوگلو
antony	انتونى
antoun	انتون
antrosio	انتروسىو
antti	انتى
anu	انو
anuchin	انوچىن
anujit	انوجىت
anukul	انوكول
anupam	انوپام
anwar	انور
anwer	انسر
anzalone	انزالونى
anzlovar	انزلوار
aoglat	اوگلت
aogori	اوگورى
aoyoun	اوىون
apel	اپل
apendice	اپندىس
aphichart	افىچارت
aphoriel	افورىل
aphrodite	افرودىت
aplin	اپلىن
aponte	اپونته
apoorva	اپوروا
appel	اپل
appelberg	اپلبرگ
applebee	اپلىبى
appleman	اپلمن
april	اپرىل
aqil	اكواىل
aqila	اگىلا
arantes	ارنتس
arbanas	ارباناس
arber	اربر
arbil	اربىل
arbur	اربور
arch	ارچ
archdale	ارچدالى
archer	ارچر
archibald	ارچىبالد
ardalich	اردالىچ
ardis	اردىس
arend	ارند
arendt	ارندت
ari	ارى
ariss	اىرىس
aristotle	ارىستوتل
arktiki	اركتىكى
arlet	ارلت
arlidge	ارلىج
arling	ارلىنگ
arm	ارم
armato	ارماتو
armeni	ارمنى
armitt	ارمىت
armontrout	ارمونتروت
armour	ارمور
armstrong	ارمسترانگ
arne	ارنه
arnett	ارنت
arnfield	ارنفىلد
arnold	ارنولد
arnot	ارنات
aronson	اىرونسون
arpin	ارپىن
arras	اراس
arrifa	ارىفا
arrington	ارىنگتن
arscott	ارسكات
arsenault	ارسنالت
arsikere	ارسىكر
arter	ارتر
artiss	ارىس
arunachalam	اروناچالام
arunah	اروناه
arvesen	اروسن
arviola	اروىولا
arya	ارىا
arzate	ارزات
asbell	اسبل
asbrink	اسبرىنك
ascoly	اسكولى
asguarian	اسگورىان
ashenden	اشندن
asherman	اشرمن
ashfield	اشفىلد
ashley	اشلى
ashmore	اشمور
ashok	اشوك
ashton	اشتون
asif	اسىف
ask	اسك
askanas	اسكنس
asma	اسما
assakul	اساكول
asselman	اسلمن
assi	اسى
assimilate	اسىمىلىت
asson	اىسون
aster	استر
astik	استىك
astley	استلى
astore	استور
astrid	استرىد
aswalap	اسوالاپ
atanacio	اتانسىو
ataras	اتاراس
atchison	اچىسون
atherton	اترتن
athey	اتى
athos	اتوس
athow	اتو
atish	اتىش
atiya	اتىىا
atka	اتكا
atkins	اتكىنز
atkinson	اتكىنسن
atle	اتل
atmosphere	اتمسفر
atram	اترام
atri	اترى
atriceps	اترىسپس
attewell	اتوىل
attig	اتىگ
attilio	اتىلىو
attlee	اتتلى
atusi	اتوسى
atwater	اتواتر
atwood	اتود
aubrey	اوبرى
aubrie	اوبرى
aucellina	اوسلىنا
auckland	اكلند
audley	ادلى
audra	اودرا
augen	اوجن
augor	اگر
august	اوگوست
augusto	اگوستو
augustyn	اوگوستىن
auker	اوكر
auld	اولد
auldridge	الدرىگ
aun	اون
aurdalen	اوردالن
aureole	اورىولى
aurho	اورهو
auriga	اورىگا
aurkleven	اوركلىون
aurnupen	اورنوپن
auslander	اوسلاندر
austbanen	اوستبانن
austern	استرن
austin	اوستىن
austrian	استرىن
austvollen	اوستولىن
austvorren	اوستورىن
auyeung	اىنگ
aveek	اوىك
aveling	اولىنگ
averell	اورل
averice	اورىك
averill	اوراىل
averis	اورىس
aversa	اوىرسا
avian	اوىان
avicenna	اوىسنا
avichay	اوىچاى
avinash	اوىناش
avis	اوىس
aviva	اوىوا
avolio	اوولىو
avraham	اوراهام
avram	اورام
avrum	اوروم
awadia	اوادىا
awan	اوان
awasthi	اواستى
awel	اول
awketts	اوكىتس
axe	اكس
axel	اكسىل
axelsson	اكسلسون
axford	اكسفرد
axthelm	اكسدلم
ayala	اىالا
ayckbourn	اىكبرن
aycock	اىكوك
ayers	اىرز
ayling	اىلىن
aylor	اىلور
aylott	اىلوت
aylward	اىلوارد
ayman	اىمن
ayn	اىن
ayse	اىسى
ayson	اىسون
ayush	اىوش
azad	ازاد
azalea	ازالىا
azhar	اژار
azlan	ازلن
azure	ازور
baabar	باابار
baba	بابا
baback	بابك
babah	بابا
babar	بابار
babcock	ببكاك
babette	بابت
babikow	بابىكو
babitz	بابىتز
babu	بابو
baburao	بابوراو
babushkin	بابوشكىن
bacar	بىسر
bachus	باچاس
back	بك
backas	باكاس
backdoor	بكدور
backer	بكر
backhurst	بكهورست
backman	بكمن
backof	بكوف
backway	بكوى
badami	بدمى
badcock	بادكك
badeloch	بدلاك
baden	بادىن
baderman	بادرمن
badian	بدىن
badir	بدىر
badrak	بدرك
badrick	بادرىك
baertie	باىرتاى
baffle	بافل
bagade	باگىد
bagga	باگا
baggarly	باگارلى
baghdad	بغداد
bagley	بجلى
bagnold	بگنولد
bagshawe	باگشاو
bagwill	بگوىل
bahamonde	بهامند
bahija	باهىه
bahro	بهرو
bai	باى
baillie	باىلى
baillieu	باىلىو
bain	بىن
baines	بىنز
bains	بىنز
bajic	باجىك
bajwa	باجوا
bak	بك
bakaya	باكاىا
baken	بىكن
bakeneset	بىكنست
baker	بىكر
bakewell	بىكول
bakos	باكوس
bakshee	باكشى
balarie	بالارى
balash	بالاش
balbir	بالبىر
balchunas	بالچوناس
bald	بالد
baldington	بلدىنگتون
baldred	بالدرد
bale	بال
baleine	بالىن
balendra	بالندرا
balfanz	بالفنز
balham	بالهام
baliga	بالىگا
balike	بالىك
balin	بالىن
balit	بالىت
ballance	بالانس
ballard	بالارد
ballast	بالاست
balleny	بالنى
ballistic	بالىستىك
bally	بالى
balma	بالما
balmaseda	بالماسدا
balmer	بالمر
balsam	بالسام
balsley	بالسلى
balson	بالسون
baltais	بالتاىس
baltaxe	بالتاكس
balthazar	بالتازار
baltzell	بالتزل
balu	بالو
banan	بنان
bandali	بندلى
banded	باندد
banderob	بندروب
bandireddi	باندىردى
bandstone	بنداستون
bandung	بندانگ
bandy	بندى
bang	بنگ
baniya	بنىا
bankler	بانكلر
banks	بانكس
bankwalla	بانكوالا
banna	بانا
banton	بانتون
bao	باو
baptist	باپتىست
baptista	باپتىستا
baqir	بقىر
barakat	بركات
barath	باراس
barbagallo	بارباگالو
barbas	بارباس
barbee	باربى
barber	باربر
barborak	باربوراك
barbour	باربور
barcroft	باركرافت
barcus	باركوس
bard	بارد
bare	بىر
bareback	بىربك
bareface	بىرفىس
barela	بىرلا
barend	بارند
barff	بارف
barford	برفورد
bargiel	بارجىل
bargus	بارگس
bari	بارى
bariaux	بارىاكس
barich	بىرىچ
bark	بارك
barkah	بركاه
barkai	باركاى
barker	باركر
barksdale	باركسدىلى
barksfield	باركسفىلد
barlas	بارلاس
barlow	برلو
barnaby	بارنابى
barnard	برنارد
barnas	بارناس
barnett	بارنت
barney	بارنى
barnum	بارنام
barnwell	برنول
baron	بارون
barone	بارون
baroness	بارونس
baronia	بارونىا
baronick	بارنىك
barraby	برابى
barracouta	باراكوتا
barre	باره
barrel	بارل
barrett	بارت
barrey	بارى
barrie	بارى
barrier	برىر
barringer	بارىنگر
barrington	بارىنگتون
barroso	باراسو
barsai	بارسى
barta	بارتا
bartelle	بارتل
bartelmus	بارتموس
bartelt	بارتلت
barth	بارث
barthakur	بارتكور
bartholomeus	بارتهولومىوس
bartle	بارتل
bartley	بارتلى
bartok	بارتك
bartolini	بارتولىنى
barton	بارتون
bartonico	بارتونىكو
bartz	بارتز
barua	باروا
baruch	باروچ
bas	باس
basem	بىسم
basha	باشا
basher	باشر
basil	بصىل
basilica	باسىلىكا
basilisk	باسىلىسك
basilius	باسىلىوس
basim	بسىم
basin	باسىن
basit	بصىت
baskar	باسكار
baskerville	باسكروىل
baskett	بسكت
basle	بسل
basma	باسما
basse	بىسه
bassel	بىسل
bassett	بست
basso	باسو
basson	باسن
bastard	باستارد
bastiaan	باستىن
bastien	باستىن
bastion	باستىن
basu	باسو
bat	بات
bataille	باتىل
bateman	بىتمن
bathurst	باترست
batra	باترا
battan	باتان
batterbee	باتربى
battey	باتى
battle	باتل
batul	بطول
baucom	باكوم
baudissin	باودىسىن
baudouin	باودوىىن
bauduyn	بادىون
baugham	باگام
baughman	باوگمن
bauhs	باوس
baukus	باوكوس
baum	باوم
baumberger	بامبرگر
baupres	باوپرس
bawa	باوا
bawcom	باوكام
bawden	باودن
bayard	باىارد
bayda	باىدا
bayern	باىرن
bayers	بىرز
bayla	باىلا
bazett	بازت
bdale	بدال
bdira	بدىرا
beach	بىچ
beacham	بىچام
beaches	بىچز
beachley	بىچلى
beaglehole	بىگلهل
beakley	بىكلى
beaman	بىمن
bean	بىن
beane	بىنه
beanie	بىنى
bear	بىر
bearcat	بركات
beard	برد
bearden	بىردن
beardmore	بىردمر
bearman	بىرمن
beartie	بىرتىه
beasley	بىسلى
beate	بىت
beaton	بىتن
beatrice	باترىس
beau	بىو
beauchamp	بىچمپ
beaufays	بىوفىز
beaumont	بىومنت
beaver	بىور
beavers	بىورز
beavis	بىوىس
bechard	بىكارد
beck	بىك
becker	بكر
beckett	بكت
beckingsale	بكىنگسىل
beckmeyer	بكمىر
beckwith	بكوىت
becky	بكى
beddow	بىدو
bedell	بدل
bednar	بدنار
bee	بى
beedle	بىدل
beehive	بىهىو
beeler	بىلىر
beelzibub	بىلزىباب
beeming	بىمىنگ
beer	بىر
beet	بىت
beethoven	بتهون
behara	بهارا
behcet	بهست
behnam	بهنام
bekis	بكىس
bekki	بكى
bela	بلا
belding	بلدىنگ
belenky	بلنكى
belinda	بلىندا
bell	بل
bello	بلو
bellomy	بلامى
belvin	بلوىن
ben	بن
benamar	بنامار
benari	بنارى
bendek	بندك
bender	بندر
bene	بنه
benet	بنت
beng	بنگ
bengt	بنگت
beniamin	بنىامىن
benjiman	بنجىمان
benker	بنكر
benner	بنر
bennet	بنت
bennetts	بنتز
bense	بنس
bensen	بنسن
benten	بنتن
bentley	بنتلى
benton	بنتون
bentow	بنتو
bentz	بنتز
benz	بنز
benzene	بنزن
beqaa	بىكا
berardi	براردى
berend	برند
berends	برندس
beresford	برسفورد
beresh	برش
bereza	برىزا
berg	برگ
bergel	برگل
bergeot	برگىوت
berger	برگر
bergman	برگمن
berin	برىن
beris	برىس
berislav	براىسلاو
berk	برك
berkey	بركى
berkley	بركلى
berlin	برلىن
berlocher	برلاچر
bermel	برمل
bernadus	برنادوس
bernal	برنال
bernard	برنارد
bernardi	برناردى
bernardin	برناردىن
bernardo	برناردو
bernards	برناردز
bernd	برند
bernhardt	برنهارت
bernher	برنهر
bernie	برنى
bernier	برنىر
berno	برنو
bernt	برنت
berry	برى
bertelson	برتلسون
berton	برتون
beryl	برىل
besam	بسام
besbris	بسبرىس
besko	بسكو
bess	بس
bethan	بتان
bethancourt	بىتانكرت
bethel	بتل
beti	بتى
bettig	بتىگ
bettio	بتىىو
betty	بتى
betza	بتزا
beusee	بىوسه
beutel	بىوتل
beutling	بىاتلىنگ
beuzeville	بوزووىل
bev	بو
beveridge	بورىج
beverly	بىورلى
bex	بكس
beyer	بىر
beyhan	بىهان
beyl	بىل
biacco	بىاكو
bian	بىان
bible	بىبل
bickerstaffe	بىكراستىف
bickerton	بىكرتن
bidee	بىدى
bidwell	بىدول
bieber	بىبر
bielecki	بىلكى
bieler	بىلر
bien	بىن
bienfang	بىنفنگ
biess	بىس
bifrost	بىفراست
big	بىگ
bigend	بىگند
bigenwald	بىگنوالد
biggs	بىگز
bigo	بىگو
bigourdan	بىگوردان
bik	بىك
bilhar	بىلهار
bilinsky	بىلىنسكى
bill	بىل
billany	بىلانى
billing	بىلىنگ
billings	بىلىنگز
billingsley	بىلىنگسلى
billington	بلىنگتن
billo	بىلو
billycock	بىلىكوك
bin	بىن
binay	بىنى
bindemann	بىندمن
bines	بىنس
binesh	بىنش
bing	بىنگ
bingen	بىنجن
bingham	بىنقام
binner	بىنر
binnie	بىنى
binns	بىنز
binod	بىنود
binoy	بىنوى
biocroft	بىوكرافت
bionic	بىىونىك
bipin	بىپىن
bippert	باىپرت
birch	بىرچ
birdsong	بردسانگ
birenboim	بىرنبوىم
birge	بىرگ
birgel	بىرگل
birk	بىرك
bismarck	بىسمارك
bissau	بىساىو
bisset	بىست
biswanath	بىزوانات
biswas	بىزواس
bittard	بىتارد
bitz	بىتز
bixler	بىكسلر
bizer	بىزر
black	بلك
blackley	بلكلى
blackman	بلكمن
blackwell	بلكول
blaha	بلاها
blaik	بلىك
blain	بلىن
blake	بلىك
blakeman	بلكمن
blal	بلال
blalock	بلالاك
blanchard	بلانچارد
blane	بلىن
blank	بلنك
blanstan	بلانستان
blas	بلس
blasi	بلاسى
blasius	بلاسىوس
blask	بلاسك
blatta	بلىتا
blattberg	بلتبرگ
blaz	بلاز
blaze	بلىز
blazek	بلازك
blazquez	بلازكىىوز
bleier	بلىر
blencowe	بلىنكو
blenkhorn	بلنكهورن
blight	بلاىت
blinco	بلىنكو
block	بلاك
blohm	بلوهم
blokland	بلكلند
bloomberg	بلومبرگ
blorenge	بلورنج
blosser	بلاسر
bloxom	بلوزوم
bluff	بلاف
bluffs	بلافس
blumcke	بلامكه
blumen	بلومن
blumenfeld	بلومنفلد
blunsdon	بلاسدن
blystone	بلىستون
blyweiss	بلاوىز
boaz	بوز
bob	باب
bobbi	بابى
bobbish	بوبىش
bobbitt	ببىت
bobby	بابى
bobe	باب
bocci	بوسى
bockoven	بوكون
bocock	بكوك
bocska	باكسكا
bodapati	بوداپاتى
boden	بودن
bodenmiller	بودنمىلر
bodla	بودلا
bodman	بادمن
bodo	بودو
boerkoel	بوركول
bogaard	بوگارد
bogdon	باگدان
boggs	باگز
boisseau	بوىسىو
boisvieux	بوىسوىكس
boisy	بوىزى
boivin	بواىوىن
bojanchev	بوژانچىو
bokel	بوكل
boker	بوكر
bolden	بلدن
boldt	بولدت
bolecek	بالسك
bolef	بولف
bolen	بولن
bolinder	بالاندر
boller	بولر
bolton	بولتان
bomber	بومبر
bomberger	بومبرگر
bomhard	بومهارد
bon	بان
bonacci	بناكسى
bonander	بوناندر
bonar	بونار
bonavoglia	بوناوگلىا
bond	باند
bonds	باندز
bongard	بونگارد
bongarts	بانگارتز
bonin	بنىن
bonita	بانىتا
bonito	بانىتو
bonitz	بونىتز
bonnabeau	بانابىو
bonnell	بانل
bonner	بانر
bonney	بانى
bonni	بانى
bonomo	بونومو
bononno	بونونو
bonura	بانىورا
booby	بوبى
booey	بواى
booher	بوهر
bool	بول
boon	بون
boonstra	بونسترا
boose	بوس
bootsie	بوتسىه
bop	باپ
borchert	بورچرت
borden	بردن
border	بوردر
borecki	بوركى
borel	بورل
borg	برگ
borge	بورگا
borgeson	برگسون
borione	بورىون
borland	برلند
borm	بورم
bormann	برمن
bormel	بورمل
borrell	بورل
borriello	بورىللو
borris	بورىس
borst	بورست
borud	بوراد
bos	بوس
bosak	بساك
boschga	بوچگا
bose	بوس
boshuysen	بوشوىسن
bosky	باسكى
bosnia	بوسنى
boss	باس
bossart	بوسارت
bosscha	بوسچا
bossom	بوسوم
bosson	بوسون
bost	بوست
bostak	بوستاك
bostic	باستىك
bostrom	بوسترام
bostwick	بوستىك
boswall	بسوال
boswell	بوسول
botari	بوتارى
botez	بوتز
botting	باتىنگ
bottrell	بوترل
bouali	بوالى
boudeweyn	بوودوىن
boudreau	بودرو
boukhny	بوخنى
boulton	بولتن
bounty	بانتى
bourcier	بورسىر
bourgea	بورجىا
bourgeois	بورگىوىس
bourlon	بورلن
bouton	بوتون
boutte	بوت
bouwer	بور
bouwers	بورز
bouzid	بوزىد
bowden	باودن
bowen	بون
bowery	باورى
bowie	بووى
bowman	بومن
bowyer	بوىر
boyer	باىر
boyes	بوىس
boyko	بوىكو
boylan	بوىلن
bozeman	بوزمان
bozhidar	بوژىدار
bozkurt	بوزكارت
brabant	برابانت
brachman	براچمن
brackney	براكنى
bradely	بردلى
braden	بردن
bradish	برادىش
bradley	برادلى
bradly	بردلى
bradshaw	برادشاو
braendle	براندل
brafford	برافورد
bragdon	برگدان
braham	براهام
brahim	براهىم
braithwaite	براىتوىت
brake	برك
bram	برام
bran	بران
branchaud	برنچاود
brand	برند
brandeis	برندىس
brandel	برندل
brandelle	برندل
brandi	برندى
brandt	برانت
brandy	برندى
brannen	برانن
branshaw	برانشاو
brashears	براشىرز
brashers	براشرز
brashier	براشاىر
brassard	براسارد
brater	براتر
bratina	براتىنا
braughton	براوتون
braunhut	بروانهات
brawn	براون
bray	برى
breakespear	برىىكپر
bream	برىم
breanndan	برىندان
breaud	برود
brecher	برچر
breck	برك
bree	برى
breedlove	برىدلاو
breitling	برىتلىنگ
brejcha	برچا
brenchley	برنچلى
brendan	برندان
brendon	برندون
brennan	برنان
brenner	برنر
brent	برنت
breslau	برسلاو
bresler	برسلر
bressman	برسمن
breton	برتون
breuer	بروىر
brevik	بروىك
brewer	بروور
brewery	برىورى
brewster	بروستر
bri	برى
briand	برىان
briber	برىبر
brice	براىس
briceno	برىسنو
bridge	برىج
bridgman	برىجمن
bridwell	برىدول
brie	براى
brier	براىر
briganti	برگانتى
bright	براىت
brighton	براىتون
brij	برىج
brimmer	برىمر
brimstone	برىمستون
brind	برىند
brindle	برىندل
brink	برىنك
brinkler	براىنكلر
brinkman	برىنكمن
brinson	برىنسن
brisbane	برىسبىن
brisbin	برىسبىن
brisinda	برىسىندا
bristol	برىستول
brita	برىتا
brito	برىتو
britt	برىت
britten	براىتن
britton	برىىتون
broadfield	برودفىلد
broadhurst	برودهاست
broadley	برودلى
brock	براك
brockley	براكلى
broda	برودا
brode	براد
broder	برودر
brohl	بروهل
broilo	بروىلو
brokaw	بروكاو
broken	بروكن
bromage	برومىج
bromberg	برومبرگ
bromley	بروملى
bromwich	براوىچ
bron	بران
brook	بروك
brooke	بروك
brooker	بروكر
brooks	بروكز
brookwell	بروكول
brossard	بروسرد
brotherton	برادرتون
broude	براد
brougham	براگهام
broun	بران
brousseau	بروسىاو
browarek	بروارك
brown	براون
browner	براونر
brownfield	براونفىلد
broz	بروز
bruck	بروك
brueckner	بروكنر
bruening	بروىنىنگ
bruines	بروىنس
brumbaugh	برامباو
brumfield	برومفىلد
brummer	برامر
bruneau	برونىىو
bruner	برونر
brunsdon	برانسدون
brunswick	برانسوىك
brunt	برانت
brunwin	برونوىىن
bruty	بروتى
brutzman	بروتزمن
bruyn	بروىن
bruzzone	برازون
bryant	برىانت
bryce	براىس
bryde	براىد
bryguy	برىگوى
bryn	برىن
bryner	برىنر
bryon	برىون
bryony	برىونى
bryson	براىسون
bubb	باب
bubble	بابل
buberel	بابىرل
bucci	بوسى
buceck	بوسك
buchalter	باچالتر
buckle	بوكل
buckley	بوكلى
buckner	باكنر
bucky	باكى
bud	بود
buda	بودا
budd	باد
budds	بادز
buddy	بادى
budi	بودى
budig	بادىگ
budnick	بادنىك
budziak	بادزىاك
buffalo	بوفالو
buffy	بافى
bugay	باگاى
buggelli	باگلى
bugos	بوگس
bugs	باگز
buhl	بوهل
bulkowski	بالكوسكى
bullard	بولارد
bulldozer	بولدزر
buller	بولر
bulloch	بولوچ
bullock	بالاك
bulow	بولو
bulsara	بالسارا
bulus	بولوس
bum	بوم
bumsoo	بامسو
bunge	بانگ
bungers	بانگرز
bunn	بان
bunny	بانى
bunten	بونتن
bunting	بانتىنگ
buraschi	بوراسچى
burden	بردن
burditt	بردىت
burfitt	بارفىت
burg	بارگ
burgaard	برگارد
burgess	برگس
burghard	بارقارد
burhan	برهان
burj	برج
burkhard	برخارد
burleson	برلسون
burling	برلىنگ
burnette	برنت
burney	برنى
burns	برنز
burr	بر
burrell	بارل
burrill	بورىل
burris	بارىس
burrup	بوراپ
bursell	بورسل
burson	برسون
burt	برت
burton	بارتن
burts	برتس
busa	بوسا
busarow	بوسارو
busch	بوش
bushnell	بوشنل
bushore	بوشور
busick	بوسىك
bussiere	بىزىر
bustamante	بوستامنت
bustillos	باستىلوس
butaysh	بوتاىش
butch	باچ
butcher	بوتچر
butte	بوت
butterworth	باترورث
buttnut	باتنات
button	باتن
buttress	باترز
buttresses	باترسس
buttuls	باتالس
buxey	بوكسى
buzbee	بازبى
byfield	باىفىلد
bygden	باىدن
byler	بىلر
byles	بىلس
bynon	باىنون
byra	بىرا
byrd	بىرد
byrne	بىرنه
byrnes	بىرنس
bysouth	باىسوت
bystander	بىستاندر
byung	بىانگ
byungse	بىونگس
byungtae	بىانگتاى
cabaniss	كبانىس
cabe	كىب
cable	كىبل
cabrello	كابرىلو
cacciola	كاكىولا
cacho	كاچو
cactus	كاكتوس
cadaver	كداور
cadle	كدل
cadman	كادمن
cadmus	كادموس
caffrey	كافرى
cagle	كاگل
caillet	كىلت
cain	كاىن
caine	كاىنى
caird	كاىرد
cakebread	كىكبرد
cala	كالا
calahan	كالاهان
calbridge	كالبرىج
caldwell	كالدول
calinisan	كالىنسان
calius	كالىىوس
call	كال
callanan	كالانان
callebaut	كالباوت
callis	كالىس
calow	كالو
calsyn	كالسىن
calvert	كالورت
camacho	كاماچو
camama	كاماما
cameron	كامرون
cameros	كامروس
camfield	كمفىلد
campagna	كامپاگنا
campbell	كامپبل
campey	كمپى
campillo	كامپىلو
canale	كانال
candau	كانداىو
candy	كندى
canfield	كانفىلد
canis	كانىس
cannava	كاناوا
cano	كانو
canon	كانن
cantara	كانترا
canyon	كانىون
cao	كاو
cape	كىپ
capistran	كپىستران
caprette	كپرت
caraher	كاراهر
carangelo	كارانجلو
carbajal	كارباجال
carbone	كاربن
carbonelli	كاربونلى
carbonneau	كاربونىا
cardenas	كاردناس
cardinali	كاردىنالى
cargill	كارگىل
carhart	كارهارت
cariaga	كارىاگا
carina	كارنىا
carl	كارل
carlin	كارلىن
carlos	كارلوس
carlton	كارلتون
carmichael	كارمىچاىل
carmody	كارمودى
carmona	كارمونا
carnelian	كارنلىان
carnell	كرنل
carnerie	كارنرى
carney	كارنى
carnie	كارنى
carol	كرول
carolyn	كارولىن
carosso	كاروسو
carpenter	كارپنتر
carr	كار
carragher	كرىقر
carrara	كارارا
carreira	كارىرا
carrier	كرىر
carrillo	كارىلو
carson	كارسون
carstens	كارستنز
carstensen	كارستنسن
cartaxo	سارتاكسو
carter	كارتر
cartwright	كارتراىت
carver	كارور
cary	كرى
casanova	كاسانووا
cascio	كاسىو
case	كىس
casertino	كاسرتىنو
casey	كىسى
cash	كش
casner	كاسنر
casriel	كاسرىل
cassara	كاسارا
cassel	كسل
casselman	كاسلمن
cassidy	كىسىدى
cassinelli	كاسىنلى
castano	كاستانو
castellot	كستلوت
caster	كستر
casti	كاستى
castillo	كاستىلو
castle	كستل
castner	كستنر
castricum	كاسترىوم
castro	كاسترو
cat	كت
catalano	كاتالانو
catanzaro	كتنزرو
catharyn	كاترىن
cathcart	كاتكارت
catherine	كاترىن
catlett	كتلت
catrijn	كاترىجن
catsimatides	كتسىماتىدس
cattell	كتل
cau	كاو
cauchon	كاچون
cauldwell	كالدول
cauligi	كالىگى
cavasin	كاواسىن
cave	كىو
cavers	كاورز
cawston	كاوستن
cazier	كازىر
cecil	سسىل
cedelle	كدل
celarier	سلارىر
celetje	سلت
celio	سلىو
cemal	كمال
cena	سىنا
cengeloglu	سنگلوگلو
cera	كرا
cerasuolo	سراسول
cernese	كرنىز
cessaro	سزارو
cetia	سىتىا
chacko	چاكو
chai	چاى
chaiken	چاىكن
chalk	چالك
chamberlain	چمبرلىن
chambers	چمبرز
champlin	چامپلىن
chand	چاند
chande	چند
chander	چاندر
chandler	چندلر
chandonia	چاندونىا
chandran	چاندران
chaney	چانى
channel	كانال
chao	چاو
chapela	چاپلا
chapman	چاپمن
chappell	چاپل
chard	چارد
charles	چارلز
charlie	چارلى
charlotte	شارلوت
charlton	چارلتن
charlyn	كارلىن
charpentier	كارپنتىر
charrick	چارىك
chartier	كارتىر
chas	چاش
chasms	چاسمز
chastain	چاستىن
chatane	چاتانى
chauhan	چاوهان
chaun	چاون
chauveau	چاووىو
chauvin	چاووىن
chavda	چاودا
chavez	چاوز
chayes	چاىز
che	چه
cheal	چىا
cheapman	چىپمن
cheatwood	چىتوود
chee	چى
cheek	چىك
cheeks	چىكز
cheeky	چىكى
cheenu	چىنو
cheesman	چىسمن
cheetham	چىتام
cheiltje	چىلتجه
chelian	چلىىان
chellaton	چلاتون
chemaly	چمالى
chembezi	چمبزى
chemello	كمللو
chen	چن
chenader	چنادر
cheney	چنى
chenteh	چنته
cherag	چراگ
cherepy	چرپى
cherie	چرى
cherrie	چرى
cherubini	چروبىنى
cheryl	چرىل
ches	چس
chesbro	چسبرو
chesney	چسنى
chesny	چسنى
chet	چىت
chetal	چتال
chetan	چىتان
chetwin	چتوىن
chevron	چورن
chi	چى
chia	چىا
chiaki	چىاكى
chiang	چىانگ
chicago	شىكاگو
chichester	چىچستر
chick	چىك
chickery	چىكرى
chickon	چىكن
chiem	چىم
chien	چىن
chiew	چىو
chik	چىك
childs	چىلدز
chillingworth	چىلىنگورث
chilly	چىلى
chin	چىن
chinen	چىنن
chiou	چىو
chip	چىپ
chirag	چىراك
chisholm	چىشولم
chism	چىسم
chistopher	كىستوفر
chitrady	چىتردى
chitta	چىتا
chittick	چىتىك
chizoba	چىزوبا
chizu	چىزو
chizuru	چىزورو
cho	چو
chokri	چوكرى
chokshi	چوكشى
cholette	شولت
choo	چو
choon	چون
chopde	چپدى
chopin	چاپىن
chopra	چاپرا
chou	چو
choudhary	چودهارى
chovanak	چوواناك
chow	چو
choy	چوى
chrescyntie	چرسكىناى
chris	كرىس
christa	كرىستا
christal	كرىستال
christall	كرىستال
christian	كرىستىان
christiana	كرىستىانا
christiansen	كرىستىانسن
christie	كرىستى
christine	كرىستىن
christman	كرىستمن
christmann	كرىستمن
christophe	كرىستوف
christopherson	كرىستوفرسون
christy	كرىستى
chrons	كرونز
chu	چو
chua	چوا
chunping	چونپىگ
church	چرچ
churchill	چرچىل
chusak	چوساك
chwolka	چولكا
cinq	سىنك
cionca	سىونكا
cirilo	سىرىلو
cirques	سىركوىس
cisneros	كىسنروس
citizen	سىتىزن
cittlau	سىتلاىو
claborn	كلبورن
clabourne	كلابورن
claertie	كلرتى
claesje	كلىسه
claeson	كلاىسون
claire	كلاىر
clamen	كلامن
clancey	كلانسى
clanfield	كلانفىلد
clanton	كلانتون
clare	كلىر
clark	كلارك
clarke	كلارك
claros	كلروس
claude	كلاودى
claudia	كلاودىا
clausing	كلازىنگ
claussen	كلوسن
clawsie	كلاوسى
clay	كلى
clayton	كلاىتون
cleavey	كلىوى
cleek	كلىك
cleere	كلىر
clewley	كلولى
cliburn	كلىبرن
cliff	كلىف
clifford	كلىفرد
clift	كلىفت
clonfero	كلونفرو
clough	كلاف
club	كلوب
clugston	كلاگستون
clumpner	كلومپنر
coast	كوست
coatney	كوتنى
cobabe	كوبىب
cobo	كوبو
cochran	كوچران
cockburn	كوكبرن
cockerill	كوكرىل
cockfield	كوكفىلد
cockroft	كاكرافت
code	كد
codogno	كودوگنو
cody	كودى
coenraad	كوىنراد
coenradus	كوانرادوس
coenraedt	كونرات
coesmans	كواسمان
coevering	كواورىنگ
coeyman	كواىمان
coffee	كافى
coffin	كافىن
cogburn	كاگبورن
coggeshall	كاگشال
cogswell	كاگسول
cohan	كوهان
cohn	كوهن
coil	كوىل
coisman	كوىسمان
col	كول
colbey	كلبى
colburn	كلبورن
colclasure	كالكلاسور
coleno	كولنو
colety	كولتى
coley	كلى
colfelt	كلفلت
colin	كولىن
collett	كالت
collette	كلت
collie	كالى
collier	كولىر
collingwood	كولىنگوود
collins	كولىنز
collum	كالوم
colman	كولمن
colombo	كلمبو
colon	كولن
colonello	كالونلو
colten	كلتن
colton	كالتون
comarow	كومارو
combee	كامبىى
combites	كامبىتز
combs	كامبز
comeau	كامىو
comer	كومر
compton	كومپتون
computer	كامپىوتر
comstock	كامستاك
conconi	كانكنت
condelli	كاندلى
conduit	كاندوىىت
cone	كون
conerly	كانرلى
confer	كانفر
cong	كانگ
conley	كانلى
conlon	كانلن
connett	كونت
connor	كونور
conover	كونوور
conroy	كانروى
constabaris	كانستابارىس
conte	كانته
convery	كانورى
cook	كوك
cookson	كوكسون
cooley	كولى
coomber	كومبر
cootjans	كوتجانز
copeland	كوپلند
coplen	كوپلن
coppeans	كوپنز
coppedge	كوپج
coppejans	كوپجانز
copps	كاپس
corbett	كوربت
corbin	كوربىن
corbit	كربىت
corcoran	كاركارن
cordes	كوردز
cordrey	كردرى
coren	كورن
corey	كورى
corkum	كوركام
corley	كورلى
cormick	كرمىك
cornelius	كورنلىوس
corneliusen	كورنلىوسن
cornellis	كورنلىز
corns	كورنز
cornuelle	كورنىول
cornwall	كورنوال
cornwell	كرنول
corradini	كورادىنى
corre	كور
correia	كورىا
corridor	كورىدور
corrigan	كورىگان
corsello	كورسلو
cort	كورت
cortell	كورتل
cortez	كورتز
coryell	كورىل
corzine	كورزاىن
cosell	كاسل
cosgriff	كازگرىف
cosgrove	كاسگروه
cosmas	كوسماس
costa	كاستا
costanza	كوستانزا
costello	كوستىلو
cote	كوت
cotlar	كتلار
cotroneo	كوترونىو
cotta	كوتا
cottle	كاتل
couch	كوچ
coughlin	كوگلىن
coulson	كولسون
counsell	كانسل
courcoul	كوركول
courtlandt	كرتلند
courtois	كارتوىز
coury	كورى
coutts	سوتس
couzin	كوزىن
coves	كووس
cowe	كوو
cowen	كوىن
cowling	كاولىنگ
coxhead	كاكسهد
coy	كوى
coyle	كوىل
coyne	كوىن
cozzi	كوزى
crabtree	كربترى
cracraft	كركرافت
craft	كرفت
craig	كراىگ
crain	كرىن
cramer	كرامر
crandlemire	كراندلمىر
cranford	كرنفرد
cranswick	كرانزوىك
crapse	كرپس
crase	كرىس
crater	كرتر
craven	كراون
crawford	كراوفورد
crawley	كراولى
cray	كرى
crealese	كرىلىز
creasey	كرىسى
creasy	كرىسى
creath	كرىث
creek	كرىىك
crepeau	كرىپىو
crespo	كرسپو
cress	كرس
crest	كرست
crests	كرستس
crevasse	كرواسه
crevasses	كرىواسز
crews	كروز
crichton	كرىشتون
crisp	كرىسپ
crispen	كرىسپن
crispijn	كرىسپىجن
criswell	كراىسول
critchfield	كرىچفىلد
crockart	كراكارت
crockett	كراكت
crockford	كروكفورد
crom	كروم
cropper	كراپر
crosby	كراسبى
cross	كراس
crossen	كراسن
croteau	كروتىو
crouchley	كراچلى
croughton	كراقتون
croume	كرومى
crouse	كروس
crowe	كرو
crowell	كراول
crown	كراون
crowson	كراوسون
croyle	كروىل
crozier	كروزىر
crumbach	سرومبچ
crumhorn	كرامهورن
crutcher	كراچر
crystal	كرىستال
csaba	سىسابا
cuenca	كونكا
culhane	كالهىن
cully	كولى
culpin	كالپىن
cumming	كامىنگ
cunitz	كانىتز
cunniff	كانىف
cuong	كىونگ
cupples	كوپلس
curran	كوران
currie	كارى
curry	كارى
curson	كرسن
curtain	كرتىن
curtis	كارتىس
curtner	كارتنر
cushman	كاشمن
cutchie	كاچىه
cuthbert	كاتبرت
cutie	كوتى
cutler	كاتلىر
cutter	كاتر
cutting	كاتىنگ
cybanski	چىبانسكى
cybermage	ساىبرمىج
cynthia	سىنتىا
cyr	سىر
cyril	سىرىل
cyrus	سىروس
daatje	دات
dabney	دابنى
daco	داكو
dada	دادا
dade	داده
dag	داگ
dagan	داگان
dagley	دجلى
dahl	دال
dahuk	داهود
dailey	دىلى
dais	داىس
dal	دال
dalager	دالاجر
dalbec	دالبك
daley	دالى
dalie	دلى
dallaire	دالاىر
dallan	دالان
dallard	دلرد
dalley	دالى
dalmia	دالمىىا
dalrymple	دالرىمپل
damian	دامىان
damiano	دامىانو
damion	دامىون
damis	دمىس
damon	دىمن
dan	دان
dana	دانا
danald	دانالد
dancer	دنسر
danco	دانكو
dancy	دانسى
dandler	دندلر
dandridge	دندرىج
danekind	دنكىند
danenbarger	داننبارگر
dangel	دانجل
dangoor	دنجور
dani	دانى
daniell	دانىل
danielle	دانىل
daniels	دانىلز
danielson	دانىلسون
danih	دنىه
danilo	دانىلو
danis	دنىس
danko	دانكو
danz	دانز
darde	درده
dare	دىر
darley	دارلى
darlington	دارلىنگتن
darnall	دارنال
darnell	دارنل
darrell	دارل
darrigues	دارىگوس
darrow	دارو
daryl	دارىل
das	داس
datri	داترى
datz	دتس
dauber	داوبر
daud	دود
daugherty	داگرتى
daulton	دالتون
daum	دوم
dauwen	داىوون
davenport	داونپرت
daverin	داورىن
davi	دىوىد
david	دىوىد
davide	دىوىد
davidian	دىوىدىان
davidson	دىوىدسون
davie	دىوى
dawes	داوس
dawkins	داكىنگ
dawning	داونىنگ
dawood	داوود
dawson	داوسان
dawud	داوود
dax	داكس
day	دى
dayr	داىر
deadfield	ددفىلد
dealy	دىلى
dean	دىن
deaner	دىنر
deangelo	دىنگلو
dear	دىر
deatherage	دترىج
debathe	دىبىت
debathonia	دىباتونىا
decker	دكر
declerck	دكلرك
deconinck	دىكانىنك
decouty	دىكاوتى
dedrick	ددرىك
deeming	دىمىنگ
dees	دىس
defroy	دفروى
degen	دىگان
degerlund	دگرلوند
degotardi	دگوتاردى
degraff	دىگراف
degraw	دىگرو
deguzman	دىگازمن
dehmel	دمل
dehner	دهنر
dehnert	دهنرت
dei	دى
deibler	دبلر
deicher	دىچىر
deininger	دىنىنگر
dekan	دكان
dekel	دىكل
dekok	دكك
del	دل
delaere	دىلاىر
delaney	دلنى
delikatny	دلىكاتنى
delisio	دلىسىو
dellinger	دىلىنگر
dellis	دلىس
dellmann	دلمان
deloris	دلورىز
delouise	دلوىس
deloura	دلورا
delrio	دلرىو
dema	دما
demarest	دىمارست
demars	دىمارس
demcak	دمكاك
demers	دمرز
demetrio	دىمىترىو
demetriou	دىمىترىو
demke	دمكه
demler	دملر
dempster	دمپستر
den	دن
denault	دناولت
denebeim	دىنبىم
deng	دنگ
denham	دنهام
denkewalter	دنكوالتر
denman	دنمن
dennell	دىنل
dennison	دنىسون
deno	دنو
denton	دنتون
denux	دنوكس
depalm	دوپالم
depaola	دىپاىولا
deporter	دىپرتر
depressive	دىپرسىو
derby	دربى
derienze	درىنز
dermott	درموت
derrick	دىرك
derro	درو
dervenis	درونىس
des	دس
desai	دىساى
desanto	دىسانتو
desgagne	دزگاگنه
desmet	دسمىت
desmond	دىسموند
desmoulins	دسمولىنز
desnoyers	دسنوىرز
desotelle	دستلى
desoto	دسوتو
desrosiers	دسروزىرز
dessent	دىسنت
detlefs	دتلفس
dettman	دتمن
detweiler	دتوىلر
devanathan	دىواناتان
devarque	داوارك
deven	دون
devender	دوىندر
devenpeck	دونپىك
devereaux	دوراوكس
devine	دىواىن
devisser	دىواىزر
devito	دوىتو
dewan	دىوان
dewar	دىوار
dewey	دىوى
dewhirst	دوهىرست
dewilde	دىوىلده
dewitt	دىوىت
dexter	دكستر
diaa	دىا
diab	دىاب
dial	داىال
diamantaras	دىامانتاراس
diamond	دىاموند
diana	دىانا
diane	دىان
diaz	داىاز
dib	دىب
dick	دىك
dickens	دىكنز
dickey	داىكى
dickow	دىكو
dicky	دىكى
dico	دىكو
die	داى
diederichs	دىدىرىچس
diedrich	دىدرىخ
dierderick	دىردرىك
dierk	دىرك
diether	دىتر
dietmar	دىتمار
dievertje	دىورته
dighe	دىگه
digweed	دىگوىد
dik	دىك
dike	داىك
dil	دىل
dilan	دىلان
dileep	دىلىپ
dilemma	دىلما
dilip	دىلىپ
diller	دىلر
dilligan	داىلاىگان
dillon	دىلن
dillworth	دىلورث
dima	دىماد
dimaryp	دىمارىپ
dimashq	دىمشاك
dimitar	دىمىتار
dimitri	دىمىترى
dimitrios	دىمىترىوس
dimitris	دىمىترىس
dimock	دىموك
din	دىن
dinah	دىنا
dineen	دىنن
dinesh	دىنش
ding	دىنگ
dinghy	دىنگى
dingsor	دىنگسور
dingyi	دىنگى
dini	دىنى
dinler	دىنلر
dinno	دىنو
dinse	دىنس
dinsmoor	دىنسمور
dint	دىنت
diomedea	دىامدى
dion	داىان
dione	داىان
dionida	دىونىدا
dionisios	داىانىسىس
dionysia	داىانىسىا
dipak	دىپاك
dipaolo	دىپاىولو
dipboye	دىپبوى
dipietro	دىپىترو
dippold	دىپلد
director	داىركتور
dirks	دىركس
dirocco	دىروكو
dishaw	دىشاو
disney	دىزنى
distel	دىستل
ditutala	دىتوتالا
divakaruni	دىواكارونى
divertje	دىورتجه
divine	داىوىن
divis	دىوىس
divya	دىوىا
dixie	دىكساى
dixon	دىكسون
dixson	دىكسون
diya	دىا
diyala	دىىالا
dizon	دىزون
djamila	دمىلا
doake	دوك
doan	دون
dobbs	دابس
dobinson	دوبىنسون
dobrikin	دوبرىكىن
dobson	دابسون
dobyns	دابىنز
doc	داك
dockhorn	داكهورن
doctors	داكترز
dodamani	دودامانى
dodds	دادس
dodell	دودل
dodge	داج
dodgen	داگن
dodier	دادىر
doe	دو
dog	داگ
dogan	دوگان
doggers	داگرز
dogs	داگز
dogwatch	داگواچ
doherty	داهرتى
dohn	دان
doi	دوى
dokkene	داكن
dolan	دولان
dolbear	دالبىر
dole	دول
dolin	دولىن
dolinar	دالىنار
dollens	دالنز
dollinger	دالىنگر
dolly	دالى
dolman	دولمان
dolmas	دالمس
dolores	دالرس
domba	دومبا
domenico	دومنىكو
domeyko	دومىكو
domingo	دومىنگو
domingues	دامىنگس
dominic	دومىنىك
dominick	دومىنىك
dominicus	دمىنىسوس
dominion	دومىنىن
dominy	دامىنى
dona	دونا
donachie	دوناچى
donaghy	دناقى
donald	دونالد
donath	دونات
donati	دوناتى
donato	دوناتو
donetsk	دونتسك
dong	دانگ
dongwei	دانگوى
dongyu	دانگىو
donini	دونىنى
donn	دن
donnelly	داننلى
donner	دانر
donny	دانى
donovan	داناوان
dooley	دالى
doortje	دورتج
doppelt	دوپلت
doppler	دوپلر
dora	دورا
doraiswamy	دورىسومى
doran	دوران
dorathee	دوراته
dorazio	دورازىو
dorchuck	دورچاك
dorel	دورل
doren	دورن
dorfman	دورفمان
dorie	دورى
dorinda	دورىندا
doris	دورىس
dorken	دوركن
dorma	دورما
dorn	دورن
dorothy	دوروتى
dorsett	دورست
dorsey	دورسى
dortchen	دورچن
dorthy	دورثى
dorwin	دوروىن
doseok	داسىوك
doss	داس
dossing	داسىنگ
dotson	داتسون
dottie	داتى
dou	دو
douanier	دوانىر
double	دابل
doucas	داكاس
doug	دوگ
douhour	دوهور
doulas	دالاس
doupnik	داپنىك
dout	داوت
dov	داو
dove	داو
dovell	دوول
dovers	داورس
dow	داو
dowaliby	دوالىباى
dowler	دولر
downes	دونس
downey	داونى
downing	داونىنگ
dox	داكس
dozier	دوزىىر
drabek	درابك
drachman	درچمن
drader	درادر
drag	درگ
draganis	دراگانىس
dragomir	درگومىر
dragon	دراگن
dragons	درگونس
draine	دراىنه
drake	درىك
dralle	درال
dramatis	دراماتىس
draper	دراپر
dream	درىم
dreamer	درىمر
dreams	درىمز
dreary	درىرى
drebes	دربس
drees	درىس
dreier	درىر
drenter	درنتر
dressner	درسنر
drew	درو
drewe	درىو
drewett	دروىت
drexel	دركسل
dreyer	دراىر
dreyfus	درىفوس
dridge	درىدجى
driedger	درىجر
drikha	درىخا
driscoll	درىسكول
driskill	درىسكىل
drnek	درنك
drolet	درالت
droomer	درومر
drop	دراپ
dror	درور
drosehn	دروزن
droste	دراست
drown	دراون
druding	درودىنگ
drudis	درودىس
druger	دراگر
drukman	دراكمن
drum	درام
drummond	دروماند
drune	درونى
dua	دعا
duarte	دوارته
dubach	داباچ
dubay	دوباى
dubear	دوبىر
dubiel	دابىل
dubinin	دوبىنىن
dubinsky	دابىنسكى
dubois	دابوىس
dubose	دابوس
dubris	دوبرىز
dubuc	داباس
duc	داك
ducharme	دوچارم
duchaylard	دوچاىلارد
duchet	دوچت
duckering	داكرىنگ
duckman	داكمن
duckworth	داكورث
duda	دودا
dudgeon	دادگىون
dudley	دودلى
dueck	دواك
duemler	داملر
duening	دوىنىنگ
duerr	دوار
duff	داف
dufour	دوفور
dugan	دوگان
dugger	داگر
duha	دوها
duhamel	داهامل
duhon	داهن
duickinck	دواىكىنك
duk	داك
dulberger	دالبرگر
dulfer	دالفر
dumbbell	دامبل
dumitru	دامىترو
dumontet	دامونتت
dumpleton	دامپلتون
dun	دان
dunae	دوناى
duncan	دونكن
dundas	دانداس
dundee	داندى
dunford	دانفرد
dung	دانگ
dungeon	دانگىون
dunham	دونهام
dunki	دانكى
dunlap	دانلوپ
dunne	دانه
dunphy	دانفى
dunsmore	دانسمور
dunten	دانتن
duparc	داپرك
duperre	داپررى
dupree	داپرى
duprie	دوپرى
dupuis	دوپىوىس
dupuy	داپاى
durand	دوراند
durham	دورهام
duross	دوراس
durr	دار
durrance	دوررانس
durrand	دوراند
durupt	دوراپت
duse	دوس
dusen	دوسن
dusko	دوسكو
dusty	دوستى
dutta	دوتا
dutton	داتون
duvivier	دوىوىر
duy	داى
duyckinck	دوىكىنك
duzat	دوزات
dwain	داىن
dwaine	داىن
dwight	داىت
dyballa	داىبالا
dyer	داىر
dykes	داكز
dykins	دىكنز
dyna	دىنا
dynamite	دىنامىت
eachus	اىچاس
eadie	ادى
eads	اىدس
eaglestone	اىجلستون
eales	اىلز
eamon	اىمون
eannarino	اىنارىنو
ear	ار
earl	ارل
earle	ارل
earley	ارلى
earnest	اىرنست
eason	اىسان
eassa	اىسا
eastburn	اىستبرن
easter	اىستر
easterbrook	اىستربروك
eastick	اىستىك
eastlake	استلىك
eastland	اىستلند
eastman	اىستمن
eastwood	اىستوود
eater	اىتر
ebach	اىباچ
ebbert	ابرت
ebdon	ابدون
ebe	ابى
eberbach	ابرباچ
eberle	ابرلى
ebert	ابرت
eboreime	ابورىمه
ebrahim	ابراهىم
ebright	ابراىت
ech	اچ
eck	اك
eckam	اىكام
ecker	اكر
eckersand	اكرساند
eckert	اكرت
eckton	اكتون
edara	ادارا
edberg	ادبرگ
eddey	ادى
edenborough	ادنبرگ
edgington	ادگىنگتون
edginton	اجىنتون
edmiston	ادمىستون
edmonds	ادموند
eduwart	ادوارت
edvard	ادوارد
edward	ادوارد
edwardsson	ادواردسن
egan	اىگان
egerton	اگرتون
egg	اگ
eggeman	اگمن
eggert	اىگرت
egilsson	اگىلسون
egli	اىگلى
egmose	اگموز
eidam	اىدمن
eidsson	ادسون
eileen	اىلىن
einke	اىنكه
einstein	انىشتىن
eirik	اىرىك
eisert	اىسرت
eisner	اشنر
eivind	اىوند
ekberg	اكبرگ
ekerslato	اكرسلاتو
eklof	اكلوف
eklund	اكلاند
ekman	اكمن
ekmundensis	اموندسىز
ekwall	اكوال
elangco	الانگكو
elbows	البوز
eldin	الدىن
eldred	الدرد
eldridge	الدرىدج
eleveld	الولد
elf	الف
elfering	الفرىنگ
elia	الىا
eliason	الىاسون
elie	الى
elin	الىن
eliot	الىوت
elison	الىسون
elizabeth	الىزابت
elkan	الكان
elkington	الىنگتون
ellam	الام
ellegaard	الگارد
ellen	الن
ellerbeck	الربك
ellery	الرى
elletson	التسون
ellinger	الىنگر
elliot	الىوت
ellison	الىسون
ellwood	الوود
elman	المن
elmar	المار
elmers	المرس
elmo	المو
elmoman	المومان
elmore	المور
elmquist	المكواست
elof	الوف
elroy	الروى
elsie	السى
elsner	السنر
elson	السون
elspeth	السپد
eltanin	التانىن
elvers	الورس
elwin	الوىن
elwood	الوود
ely	الى
elya	الىىا
elyse	الاىس
elz	الز
embar	امبار
embassy	امباسى
emberley	امبرلى
emberling	امبرلىنگ
emerald	امرالد
emery	امرى
emilie	امىلى
emilio	امىلىىو
emily	امىلى
emit	امىت
emlen	املن
emmanuel	امانىول
emmen	امن
emmett	امىت
empereur	امپرور
empey	امپى
empson	امپسون
emre	امر
ems	امس
emyr	امىر
ender	اندر
enderborg	اندربورگ
enderby	اندربى
endre	اندر
endurance	اندىىورانس
enete	انت
enfant	انفانت
enfield	انفىلد
engaged	اىنگىجد
engebretsen	انگبرتسن
engebretson	انجبرتسون
engelhardt	انگلهارد
engelhorn	انگلهورن
engelina	انجلىنا
engels	انگلز
engelsma	انگلاسما
engelson	انگلسون
engeltje	انجلجى
engi	انجى
england	انگلند
englander	انگلاندر
englund	انگلاند
enigma	انىجما
enkerli	انكرلى
ennis	انىس
enno	انو
eno	انو
enoksson	اىنوكسن
enos	انوس
enotiadis	انوتىىادىس
enrico	انرىكو
enrique	انرىكىو
enriquez	انرىكىىوز
entrikin	انترىكىن
entropy	انتراپى
envoy	انووى
enyart	انىارت
enying	انىنگ
enyo	انىىو
eoin	اىوىن
eos	اىوس
eosin	اىوسىن
epp	اپ
epperly	اپرلى
epperson	اىپرسون
eppert	اىپرت
eppstein	اپىستىن
epshteyn	اپشتىن
erach	اراش
eran	اران
erasmus	اراسموس
erdmann	اردمن
ereby	اربى
eremin	ارمىن
erez	ارز
erhard	ارهارد
erica	ارىكا
erick	ارىك
erickson	ارىكسون
ericson	ارىكسون
erik	ارىك
erika	ارىكا
eriksen	ارىكسن
eriksson	ارىكسون
erin	ارىن
ermrey	ارمرى
eronen	ارونن
ersheid	ارشىد
erskine	ارسكاىن
ertle	ارتل
escalante	اسكالانت
eskeldson	اسكلدسون
eskite	اسكاىت
esler	اسلر
esparza	اسپارزا
esquivel	اسكوىوىل
estanol	استانول
estes	استس
esteves	استىوس
estrugo	اىستراگو
ethilrede	اتىلرد
etienne	اتىنى
etinzon	اتىنزون
etkins	اتكىنز
ettinger	اتىنگر
etue	اتو
eugene	اوگنه
eugenio	اوگنىو
eustis	اىوستىس
evangelista	اونگلىستا
evans	اىوانز
evelyn	اىولىن
evens	اىونس
everhart	اورهارت
evers	اىورس
eversberg	اورسبرگ
everts	اورتس
every	اورى
ewacha	اواچا
ewald	اىوالد
ewing	اوىنگ
ewins	اوىنز
exile	اكساىل
eye	اى
eyes	اىز
eyles	اىلىس
eyman	اىمن
eynon	اىنون
eyntje	اىنژ
eyre	اىر
eyster	اىستر
ezor	ازر
fabbro	فبرو
faber	فىبر
fabiano	فابىانو
fabre	فابره
fabris	فابرىس
fabro	فابرو
fac	فك
face	فىس
fadila	فادىلا
fadl	فادل
fagan	فاگان
fagans	فاگانس
fagen	فاجن
fahd	فحد
fair	فىر
fairbairn	فىربرىن
fairbank	فاىربانك
fairhurst	فىرهرست
fairuz	فىروز
fairweather	فىرودر
faiz	فاز
faiza	فاىزا
faizel	فاىضل
fakhri	فخرى
fakhriyya	فخرىا
falchuk	فالچوك
falconer	فالكونر
fales	فالز
falk	فالك
fallate	فلات
fallon	فالون
famus	فامىوس
fan	فن
fandrich	فاندرىچ
fane	فنى
farag	فراق
farago	فاراگو
farah	طراح
farer	فرر
farid	فرىد
fariha	فرىها
farkas	فاركاس
farley	فرلى
farmer	فارمر
farouk	فاروك
farrell	فارل
farrior	فارىور
farrugia	فاروگىا
farwaniyah	فرونىاه
fasel	فاسل
fash	فاش
fasig	فسىگ
fast	فست
faucett	فاوست
faulkner	فالكنر
faultless	فالتلس
faunce	فاونس
fausett	فاوست
faust	فاوست
fauvel	فاول
fawaz	فاواز
fawzi	فاوزى
fayette	فاىت
fayiz	فاىز
fayne	فاىن
fearn	فىرن
feather	فدر
fechner	فچنر
feder	فدر
federle	فدرل
federman	فدرمن
feehan	فىهان
feely	فىلى
feenan	فىنان
feeney	فىنى
feil	فىل
feiler	فىلر
felawka	فلاوكا
felder	فلدر
feldman	فلدمان
feldspar	فلدسپار
felice	فلاىس
felices	فلىسز
felix	فلىكس
felizardo	فلىزاردو
fellini	فلىنى
fellows	فىلوز
felteau	فلتىو
femea	فمىا
fenchurch	فنچارچ
fender	فندر
feng	فنگ
fenn	فن
fenner	فنر
fennis	فىنىس
fenske	فنسكى
fentiman	فنتىمان
fenton	فنتون
fenyes	فنىس
fera	فرا
ferdig	فردىگ
ferdinand	فرداىنند
ferguson	فرگوسن
fernandes	فرناندس
fernandez	فرناندز
fernando	فرناندو
ferran	فران
ferree	فرى
ferrier	فرىر
ferrington	فرىنگتون
ferris	فرىس
fertik	فرتىك
fetch	فتچ
fetchen	فتچن
fetra	فترا
fetter	فتر
fiabane	فىابان
fiasconaro	فىاسكونارو
fick	فىك
fidalgo	فىدالگو
fidel	فىدل
fidler	فىدلر
fielek	فىلك
fife	فاىف
figard	فىگارد
fike	فاىك
filias	فىلىاس
fils	فاىلس
fin	فىن
finan	فىنان
finch	فىنچ
finelli	فىنلى
finerty	فاىنرتى
finestone	فاىنستون
finke	فاىنك
finkle	فىنكل
finlay	فىنلى
finley	فاىنلى
finn	فىن
finnin	فىنىن
finstad	فىنستاد
finton	فاىنتون
fiore	فىور
fish	فىش
fishbein	فىشبىن
fisher	فىشر
fisk	فىسك
fitch	فىتچ
fitta	فىتا
fitzgerald	فىتزجرالد
fitzwell	فىتزول
fix	فىكس
flaherty	فلاهرتى
flame	فلىم
flardinga	لاردىنگا
flat	فلات
fleck	فلك
fleming	فلىمىنگ
flemmer	فلمر
flesti	فلستى
fletje	لتجى
flickinger	فلىكىنگر
flinders	فلىندرز
flint	فلىنت
flodin	فلودىن
flor	فلور
flora	فلورا
florek	فلورك
florence	فلورنس
flores	فلورس
flowers	فلوورز
floyd	فلوىد
fluche	فلوچه
fluckiger	فلاكىگر
flute	فلوت
fluur	فلور
fly	فلاى
flygare	فلاىگىر
fodor	فادور
folkins	فلكىنز
folliot	فالىوت
folsom	فالسام
foltak	فالتاك
fondo	فوندو
fongen	فونگن
foniok	فونىوك
fontenot	فونتنوت
fontes	فانتس
forbes	فوربس
force	فورس
forde	فورد
fordham	فوردهام
forero	فوررو
forget	فرگت
forgy	فورجى
fork	فورك
forman	فورمن
forrest	فارست
forsale	فورسىل
forsberg	فورسبرگ
forsblom	فورسبلام
forsyth	فورساىت
forsythe	فورساىت
forte	فورت
forts	فورتس
fosdal	فسدال
fossberg	فاسبرگ
fosseng	فوسنگ
fotinos	فوتىنوس
fotis	فاتىس
foulds	فولدز
foulk	فولك
fourney	فورنى
fournie	فورنى
fournier	فورنىر
fouts	فوتس
fowler	فولر
fowlkes	فولكس
fownes	فاونس
fox	فاكس
fozzard	فوزارد
fradkin	فردكىن
fraenkel	فرانكل
fragen	فرجن
frahm	فرام
framson	فرامسون
france	فرانس
francisca	فرانسىسكا
franck	فرنك
francke	فرنكه
franco	فرانكو
francois	فرنسوىس
francoys	فرانكوىس
frandsen	فراندسن
frangakis	فرانگاكىس
franke	فرنك
frankel	فرانكل
franklin	فرنكلىن
franko	فرانكو
frankson	فرنكسون
franscyntje	فرانسىنتژ
franser	فرانسر
frantisek	فرانتىسك
frantzen	فرانتزن
fraser	فرسر
frazer	فرازر
frazier	فرازىر
fred	فرد
fredda	فردا
freddie	فردى
freddy	فردى
frederico	فردرىكو
frederik	فردرىك
frederking	فردركىنگ
fredette	فردت
fredrick	فردرىك
fredrik	فردرىك
free	فرى
freeburg	فرىبرگ
freedman	فرىدمن
freels	فرىلز
freemal	فرىمال
freer	فرىر
freese	فرىز
freeto	فرىتو
freidin	فرىدىن
freiling	فرىلىنگ
freilinger	فرىلىنگر
freimuth	فرىموت
freitas	فرىتاس
freivogel	فرىووگل
freiwald	فرىوالد
french	فرنچ
frenkel	فرنكل
frenzel	فرنزل
fretwell	فرىتول
freyermuth	فرىرمات
friday	فراىدى
frieda	فرىدا
friedberger	فرىدبرگر
friedl	فرىدل
friedman	فراىدمن
friedmar	فرىدمار
fries	فرىس
friess	فرىس
frink	فرىنك
fritgersa	فراىتگرسا
frits	فرىتس
fritton	فرىتن
fritzius	فرىتزىوس
frix	فرىكس
frnaciscus	فرانسىسكاس
frome	فرم
fromhein	فرومىن
fromson	فرامسان
frost	فراست
fry	فراى
fubler	فابلر
fuchs	فاچس
fude	فود
fudenberg	فادنبرگ
fuess	فوىس
fuetterer	فوترر
fuhrmann	فورمن
fui	فوى
fujioka	فوجىوكا
fujita	فوجىتا
fujiwara	فاجىوار
fulconis	فولكانىس
fulghum	فولگام
fulkerson	فالكرسون
fullen	فولن
fuller	فولر
fullman	فولمن
fulton	فالتون
fumerton	فومرتون
fundal	فوندال
fungus	فانگوس
funky	فونكى
furat	فارات
furdesanden	فوردساندن
furey	فورى
furlong	فرلانگ
furrows	فروز
furtek	فارتك
fuzzy	فازى
gaal	گال
gaba	گابا
gabara	گابارا
gabi	گبى
gabler	گابلر
gabor	گابور
gabrielle	گابرىله
gabrielsson	گابرىىلسون
gadbois	گادبوىس
gadbury	گادبرى
gades	گىدز
gadi	گادى
gadil	قدىل
gael	گال
gaeris	گارىس
gaetz	گاىىتز
gaffin	گافىن
gaffney	گافنى
gagne	گاگنه
gaherty	گاهرتى
gail	گىل
gaillot	گىلوت
gainor	جاىنور
gair	گىر
galahad	گالاهاد
galbavy	گالباواى
gale	گىل
galea	گالا
galen	گالن
gali	گالى
galibert	گالىبرت
galila	قدىلا
galileo	گالىله
galko	گالكو
gallagher	گالاگهر
gallant	گالانت
gallatin	گالاتىن
gallaty	گالىتى
galley	گالى
galli	گالى
gallion	گالىون
gallop	گالپ
gallula	گالولا
gallun	گالان
galmiche	گامىشه
galo	گالو
galpin	گالپىن
gamache	گاماك
gamage	گمىج
gamal	گامال
gambino	گامبىنو
gamero	گامرو
gammel	گامل
gammon	گامون
gan	گان
ganapathy	گاناپاتى
ganatra	گاناترا
gandy	گاندى
ganesan	گانىسان
gang	گانگ
gannon	گانون
gans	گانس
ganter	گانتر
gantert	گانترت
ganti	گانتى
ganzak	گانزاك
gao	گاو
gapen	گىپن
garance	گارانس
garbee	گاربى
garces	گارسس
garcia	گارسىا
gardner	گاردىنر
gareth	گرت
garfield	گارفىلد
garfinkel	گارفىنكل
garg	گرگ
garito	گارىتو
garms	گارمز
garner	گارنر
garnett	گارنت
garofalo	گاروفالو
garon	گارن
garrett	گارت
garrick	گارىك
garrod	گارود
garruto	گاروتو
gartin	گارتىن
gartmann	گارتمن
gascoyne	گسكوىن
gashler	گاشلر
gasic	گاسىك
gaskin	گاسكىن
gaskins	گسكىنز
gaspar	گاسپار
gasper	گاسپر
gastineau	گاستىنىو
gastli	گستل
gat	گات
gatcombe	گاتكومب
gate	گىت
gateley	گاتلى
gates	گاتس
gatlin	گاتلىن
gatta	گاتا
gatz	گاتز
gaudrault	گدرالت
gaudreau	گادرو
gaut	گات
gauthier	گاوتىر
gavazzeni	گاوازنى
gavin	گىوىن
gawne	گاىون
gaya	گاىا
gayler	گىلر
gayman	گاىمن
gaynell	گاىنل
gaynor	گاىنور
gearhart	گىرهارت
geddis	گدىس
gedeck	گدك
gee	جى
geertruyd	گىرتروىد
geervliet	گرىولىت
geier	گىر
geiger	گىگر
geiser	جىسر
geitgey	گىتگى
geldefsman	گلدفسمن
geleta	گىلىتا
gell	جل
gellrich	گلرىك
gemmell	جمل
gems	جىمز
gendreau	جندرىاو
gendrich	جندرىچ
genks	گنكس
gentges	جنتجس
gentry	جنترى
geocaris	گوىكارىس
geoff	جاوف
georgeu	جورجىو
georgia	جورجىا
gepje	گپه
geraghty	گراگتى
gerald	جرالد
gerard	جرارد
gerardi	جراردى
gerardin	جىراردىن
gerbes	گربس
gerhardt	گرهارت
gerhart	گرهارت
germack	گرماك
germuska	جىرماسكا
gerringe	گرىنگه
gerritse	گرىتس
gerrity	جرىتى
gerritzon	گرىتزن
gersappe	گرساپه
gerstel	گرستل
gerstl	جرستل
gerth	گرس
gertrude	گرترود
geston	جستون
gettys	گتىس
ghalib	گلىب
ghaliya	قالىا
gharbiyah	غربىه
ghayth	غىث
ghufran	گافران
giacobe	جىاكوب
giancola	گىىانكولا
giannasi	گىاناسى
gianni	جىانى
gibbins	جىبىنس
gibboni	گىبونى
gibbons	گىبونز
gideon	گىدون
gidewall	گاىدوال
giegel	گاىگل
gift	گىفت
gijsbertus	گىجسبرتوس
gil	گىل
gilbert	جىلبرت
gilby	گىلباى
gill	جىل
gillen	گىلن
gillespie	گىلسپى
gillett	ژىلت
gilley	گىلى
gilliam	گىلىام
gillie	گىلى
gillies	گىلىز
gillis	گىلىز
gillogly	گىلاگلى
gilmer	گىلمر
gilner	گىلنر
gilpin	گىلپىن
gilroy	گىلروى
gimenez	گىمنز
gimeno	گىمنو
ginsburg	گىنسبرگ
ginton	جىنتون
giordani	جىاوردانى
giovanni	جىووانى
girard	جرارد
girl	گرل
gische	گىشه
gitlin	گىتلىن
gitnick	گىتنىك
gitomer	گىتومر
gittelman	گىتلمن
giuliani	جولىانى
givon	گىوون
gizaw	گىزاو
glacier	گلاسىىر
glaciers	گلسىرز
glandorf	گلندورف
glass	گلس
glassco	گلاسكو
glatz	گلاتز
gleason	گلىسون
gleich	گلىچ
gleichman	گلىچمن
gleick	گلىك
gleizer	گلىزر
glenn	گلن
glenns	گلىنز
glicksman	گلىكسمن
gloege	گلوج
gloria	گلورىا
glynn	گلىن
gnagy	گناگى
gnishilda	جنىشىلدا
gnosis	گنوسىس
gobble	گاببل
goble	گوبل
goch	گوش
godau	گودا
godbout	گادبت
goddijn	گادىجن
godel	گودل
goderre	گدر
godewyn	گودىواىن
godfrey	گادفرى
godfroid	گادفروىد
godman	گادمن
godson	گودسون
goegan	گوگان
goering	جورىنگ
goerwitz	جوروىتز
goff	گاف
goguen	گوگوان
goh	گوه
gohde	گوهد
goheen	گوهىن
goland	گولاند
gold	گلد
goldberger	گلدبرگر
golder	گلدر
goldfoot	گلدفوت
golding	گلدىنگ
goldkamp	گلدكمپ
goldman	گلدمن
goldsteen	گلداستىىن
goldsworthy	گلدزورثى
gollan	گولان
golub	گلوب
gomes	گومز
gomez	گومز
gonderzik	گاندرزىك
gonna	گوننا
gonot	گونوت
gonville	گانوىل
gony	گونى
gonyer	گانىر
gonzalez	گنزالس
gonzalo	گونزالو
good	گود
goodall	گودال
goodenough	گوداىناف
goodger	گوودگر
goodhew	گودهو
gooding	گوودىنگ
goodman	گودمان
goodrum	گودرام
goodsen	گودسن
goodwin	گودوىن
gooijer	گوىىجر
goolsbee	گولسبى
goor	گور
gooshy	گوشى
gootee	گوتى
gootjes	گوتجس
gopalan	گوپالان
gopinath	گوپىنات
gopisetty	گاپىستى
goralwalla	گورالاوالا
goran	گوران
gorav	گوراو
gorberg	گوربرگ
gordan	گردان
gorde	گورد
gordin	گوردىن
gore	گور
gorel	گورل
gorgon	گورگان
gorgons	گورگانز
gorik	گورىك
gorinchem	گورىنمن
goringe	گورىنگ
goris	گورىس
gorm	گورم
gornall	گورنال
gorospe	گوراسپى
gorry	گورى
gorton	گورتون
gorwitz	گوروىتز
gosewitz	گوزوىتز
gosling	گاسلىنگ
gossard	گاسارد
gossler	گاسلر
gosta	گاستا
gostelow	گاستلاو
gostin	گاستىن
goswell	گاسول
gothic	گوتىك
gotseff	گاتسف
gotthard	گاتهارد
gottlieb	گاتلىب
goucher	گاچر
gouda	گوىودا
goudal	گودا
goudier	گودىر
goudreau	گودرو
goudswaard	گادسوارد
gough	گاف
goulden	گالدن
goulding	گولدىنگ
gourlay	گورلى
gourmet	گورمت
gouvousis	گوووسىس
goverd	گاورد
govil	گوىل
govind	گاوىند
govindan	گاوىندان
govinder	گووىندر
gowan	گوان
gowell	گوىل
gower	گاور
gowlett	گولت
gozzi	جوزى
graae	گراىى
graben	گرابن
grabiner	گرابىنر
grabnar	گرابنار
grace	گرىس
graduation	گرجواىشن
grady	گردى
graf	گراف
graft	گرافت
grah	گراه
graham	گراهام
grahame	گراهام
grahorna	گراهرنا
graifer	گرىفر
gralian	گرالىن
gramsas	گرامسس
gran	گرن
grand	گرند
grande	گراند
grandidier	گرندىدىر
grandmaster	گرندمستر
granger	گرنجر
granicher	گرنىچر
granli	گرنلى
grant	گرانت
grantham	گرانتام
granvin	گرانوىن
granzeau	گرانزىو
graphite	گرفىت
graser	گرىسر
grass	گرس
grasteinen	گرستىنن
grater	گراتر
grau	گراو
graw	گراو
gray	گرى
greanias	گرىنىاس
greco	گركو
green	گرىىن
greenberg	گرىنبرگ
greenidge	گرىنىج
greenough	گرىنو
greenwald	گرىنوالد
greenwood	گرىنوود
greer	گرىر
greewnood	گرىونود
greg	گرگ
gregg	گرگ
gregoire	گروگورى
gregor	گرىگور
greiff	گرىف
greig	گرىگ
gremban	گرمبان
grenander	گرناندر
grensing	گرنسىنگ
grenville	گرنوىل
gretchen	گرتچن
gretta	گرتا
greuel	گرىول
gribble	گرىبل
griefer	گرىفر
grieger	گرىگر
griepenkerl	گرىپنكرل
grieve	گراىىو
griff	گرىف
griffis	گرىفىس
griffiths	گرىفىتس
griffy	گرىفى
grillenbeck	گرىلنبك
grimme	گراىم
grindley	گرىندلى
grinham	گرىنهام
grinsven	گرىنسون
griseldis	گرسلدىس
grishilde	گرىشلد
grismore	گرىسمور
grist	گرىست
griswold	گرىسولد
grit	گرىت
gritz	گرىتز
grivas	گراىواس
grizzly	گرىزلى
groat	گروت
groce	گروس
groebe	گروبى
groenink	گرونىنك
groenveld	گروىنولد
grog	گراگ
grohol	گروهول
groner	گرونر
groom	گروم
groovy	گرووى
grosek	گروسك
grosse	گروسى
grosser	گراسر
grothause	گروتهاوس
grout	گروت
grov	گراو
grove	گراو
grover	گروور
grubb	گراب
gruen	گروىن
gruhn	گران
grunberger	گرانبرگر
grunewald	گرونوالد
gruskin	گراسكىن
guan	گوان
guang	گوانگ
guanyao	گوانىاو
gubbin	گوبىن
gudat	گودات
gudata	گوداتا
gudgel	گادگل
guest	گست
guethlein	جوتلىن
gui	گوى
guido	گوىىدو
guidry	گاىدرى
guilford	گىلفرد
guillaume	گىلام
guillerm	گىلرم
guillermo	گىلرمو
guillory	گىلرى
guimond	گاىموند
guitard	گىتارد
gul	گل
gulch	گالچ
gulf	گلف
gull	گال
gulledge	گالج
gullett	گالت
gulovsen	گالوسن
gummerus	گامروس
gunawan	گاناوان
gunderson	گاندرسون
gundlach	گاندلچ
gung	گانگ
gunnar	گانار
gunnel	گانل
gunnerus	گانروس
gunter	گانتر
gunther	گانتر
gunthorpe	گانتورپ
guntram	گانترام
guochun	گوچان
guoqiano	گوكىانو
gupta	گاپتا
gupte	گوپته
gupwell	گوپول
guralp	گورالپ
gurdev	گوردف
gurinder	گورىندر
gurley	گرلى
gurney	گورنى
gurrola	گارولا
gursky	گارسكى
guru	گورو
gurudevan	گارادوان
gurusamy	گوروسامى
gus	گاس
guscott	گاسكات
guse	گىوز
gusev	گوسف
guslick	گاسلىك
gussie	گاسى
gustav	گوستاو
gustavus	گوستاوس
gutman	گاتمن
gutmann	گاتمن
gutteridge	گاترىج
gutwein	گاتوىن
gutzwiller	گاتزوىلر
guy	گاى
guyatt	گىات
guyer	گاىر
guzek	گازك
gwillim	گوىىلىم
gwin	گوىن
gwynn	جىن
haba	هابا
haber	هابر
habercom	هابركام
habereder	هابردر
haberlach	هابرلچ
haberman	هابرمن
habiba	حبىبا
habura	هابورا
hacker	هكر
hackett	هكت
hacking	هاكىنگ
hackley	هاكلى
hackshaw	هكشو
hadavi	هداوى
hadaya	هداىا
haddock	هداك
haddy	هادى
hadil	حدىل
hadiya	هدىا
hadland	هدلند
hadley	هادلى
hadramawt	هادرامات
hafer	هافر
hafs	حدس
haga	هاگا
hagan	هاگان
hagelin	هاگلىن
hageman	هاگمن
hagen	هىگن
hager	هاگر
haggard	هاگارد
hagin	هاگىن
hagir	هگىر
hagler	هاگلر
haibach	هىباخ
haich	هاىچ
haidar	حىدر
haifa	حىفا
haik	هىك
hail	حىل
hailey	هاىلى
hain	هاىن
haj	هاج
hajar	حجر
hajery	هجرى
hakim	حكىم
hakulinen	هاكولىنن
halab	حلب
halat	هالات
haldre	هالدر
hale	هالى
haley	هالى
halkedis	هالكدىس
hall	هال
hallam	هالام
halleck	هالك
hallen	هالن
haller	هالر
hallert	هالرت
halliburton	هالىبرتون
halm	هالم
halpin	هالپىن
halsted	هالستد
hamachi	هاماچى
hamad	حامد
hamah	حماه
hamam	حمام
hambidge	همبىج
hamdan	حمدان
hami	هامى
hamid	حمىد
hamill	هامىل
hamilton	هامىلتن
hammans	هامانز
hammarquist	هاماركوىىست
hammel	هامل
hammer	هامر
hammond	هاموند
hamparian	هامپرىون
hampshire	هامشاىر
hampton	هامپتون
hamra	حمرا
hamza	حمزا
han	هان
hanaa	حنا
hanan	هنان
hand	هند
hands	هندز
hanebuth	هانبوت
hani	هانى
hanifa	هانىفا
haniyya	حانىه
hanke	هانكه
hanks	هانكز
hannaford	هانافورد
hannemann	هانىمن
hannu	هانو
hansen	هنسن
hansher	هانشر
hanson	هانسون
hanssen	هانسن
hansson	هانسون
hao	هاو
har	هار
harald	هارلد
haramoto	هارموتو
harari	هارارى
haratz	هاراتز
harber	هاربر
harbidge	هاربىگ
harbor	هاربور
harbour	هاربر
harbud	هاربد
harburn	هاربرن
hardiman	هاردىمن
hardin	هاردىن
harding	هاردىنگ
hardison	هاردىسون
hares	هارس
hargroves	هارگراوز
haricken	هارىچن
hariharan	هارىهاران
harincar	هارىنكار
harith	حرىث
harkcom	هاركوم
harker	هاركر
harkin	هاركىن
harkins	هاركىنز
harlan	هارلن
harland	هارلند
harlow	هارلو
harman	هارمان
harms	هارمز
harold	هارولد
haroon	هارون
haroun	هرون
harpe	هارپ
harper	هارپر
harpold	هارپولد
harrell	هارل
harrer	هارر
harrig	هاررىگ
harrison	هرىسون
harrow	هارو
harsh	هارش
harsha	هارشا
hartel	هارتل
harter	هارتر
hartfield	هارتفىلد
hartigan	هارتىگان
hartley	هارتلى
hartmann	هارتمن
hartog	هارتاگ
hartwell	هارتوىل
haruhisa	هاروهىسا
haruni	هارونى
harv	هرو
harvard	هاروارد
harvell	هارول
hasakah	هسكاه
hasan	حسن
hasbrouck	هاسبروك
hascall	هاسكال
haskel	هاسكل
haskell	هاسكل
haslum	هاسلوم
hasna	حسنا
hass	هاس
hasse	هس
hassett	هاست
haste	هست
hastings	هستىنگز
hatcher	هتچر
hatem	هاتم
hatmaker	هاتمىكر
hatrell	هاترل
hatton	هاتون
hau	هاو
havard	هاوارد
haven	هاون
havola	هاوولا
haw	هاو
hawdon	هاودون
hawk	هاوك
hawken	هوكن
hawker	هاوكر
hawkin	هاوكىن
hawkins	هاكنىس
hawkinson	هاىوكىنسون
hawks	هاكس
hawley	هاولى
hawn	هاون
hawtin	هاوتىن
haxel	هاكسل
hayden	هىدن
haynes	هىنز
haynie	هاىنى
hayter	هاىتر
hayward	هىوارد
hazelton	هزلتون
hazen	هازن
head	هد
headland	هدلند
headley	هدلى
heald	هىلد
healey	هىلى
healton	هلتون
hean	هىىن
heard	هرد
hearley	هىرلى
hearn	هرن
hearne	هىرنه
hearth	هارت
heather	هىتر
heaton	هىتون
hebborn	هبورن
hebenton	هبنتون
hecke	هك
hecker	هكر
hecking	هكىنگ
hector	هكتور
hedin	هدىن
hedrick	هدرىك
heelan	هلان
heerdegen	هىردگن
heetan	هىتن
heeter	هىتر
heezemans	هىزمانس
heffler	هىفلر
heffron	هفرون
hegarty	هگارتى
heggie	هگى
hegyi	هگى
hehman	ههمن
hei	هى
heiberg	هىبرگ
heiden	هىدن
heiderich	هىدرىچ
heidmann	هاىدمن
heidner	هىدنر
heifetz	هىفتز
heights	هىتس
heigl	هىگل
heikki	هىكى
heiko	هىكو
heil	هىل
heiland	هىلند
heim	هىم
heinly	هىنلى
heinonen	هىنونن
heinous	هىنوز
heintz	هىنتز
heinz	هىنز
heiser	هىسر
heiss	هىس
hekezen	هكزن
helal	هلال
helbig	هلبىگ
helbling	هلبلىنگ
helen	هلن
helena	هلنا
helfman	هلفمن
helga	هلگا
helke	هلك
hell	هل
hellekant	هلكانت
hellen	هلن
hellerstein	هىلىرشتىن
helliwell	هلىول
hellmer	هلمر
hellstrom	هلستروم
hellwege	هلوج
helman	هلمن
helmenstine	هلمنستاىن
helms	هلمز
helou	هلو
hemer	همر
hemmer	همر
hempe	همپ
hemstede	هىمستد
hendee	هندى
henderson	هندرسن
hendrica	هندرىكا
hendrickje	هندرىكج
hendricks	هندرىكس
hendricus	هندرىكس
hendriks	هندرىكس
hendrikse	هندرىكسه
henegan	هىنگان
henkel	هنكل
henle	هنل
henley	هنلى
henneke	هنىك
hennenfent	هننفنت
henningsen	هنىنگسن
henriet	هنرىت
henrik	هنرىك
hensley	هنسلى
hentig	هنتىگ
hentje	هنتجه
henze	هنز
hepler	هپلر
herbert	هربرت
herd	هرد
herdsfield	هرداسفىلد
herlevi	هرلوى
herlindis	هرلاىندىز
herman	هرمان
hermann	هرمان
hermans	هرمانس
hermes	هرمز
hermoso	هرموسو
hernandez	هرناندز
herndon	هرندون
herr	هر
herrera	هررا
herrick	هرىك
herring	هرىنگ
herringshaw	هرىنگشاو
herrman	هرمان
herrmann	هرمان
hertweck	هرتوك
hervey	هروى
hesemans	هسمنس
hesse	هسه
hester	هستر
hethcox	هتكوكس
hetrick	هترىك
hetzler	هتزلر
heuser	هىوزر
hewitt	هوىت
heyltje	هىلتج
heymann	هىمن
hibberd	هاىبرد
hibbert	هىبرت
hibbs	هاىبز
hickey	هىكى
hickman	هىكمن
hidajat	هىداجات
hieronimus	هرونىموس
higdon	هاىگدان
highland	هاىلند
highlord	هاىلورد
higonnet	هىگونت
hikaru	هىكارو
hildebrand	هىلدبراند
hilker	هىلكر
hill	هىل
hille	هىل
hillenbrand	هىلنبرند
hillery	هىلرى
hilletje	هىلتجه
hillis	هىلىس
hills	هىلس
hillyard	هىلىارد
hilmer	هىلمر
hilsenteger	هىلسنتىگر
hilton	هىلتن
hiltz	هىتز
hime	هاىم
hin	هىن
hince	هىنس
hinchey	هىنچى
hinchley	هىنچلى
hinchliffe	هنچلىف
hind	هىند
hinely	هاىنلى
hiner	هىنر
hines	هىنز
hinson	هىنسون
hinton	هىنتون
hinz	هاىنز
hiongun	هىونگان
hipgrave	هىپگرىو
hipp	هىپ
hipps	هىپس
hirai	هىراى
hird	هىرد
hirota	هىروتا
hirt	هىرت
hisan	هىسان
hiscocks	هىسكوكس
hise	هاىز
hisel	هىسل
hitchman	هىچمن
hitson	هىتسون
hitz	هىتز
hixon	هىكسون
hlavenka	لاونكا
hlavin	هلاوىن
hoadley	هوادلى
hoar	هوار
hobbs	هابز
hoborough	هابورگ
hocdet	هاكدت
hochhalter	هاچهالتر
hockey	هاكى
hodgeman	هاگمن
hodgers	هاجرز
hodges	هاجس
hodgin	هودگى
hodgkins	هودكىنز
hoffbeck	هافبك
hoffman	هافمن
hoffmann	هافمن
hofgaard	هوفگارد
hoford	هوفرد
hogan	هوگان
hogarty	هوگارتى
hoge	هوگ
hogg	هوگ
hohensohn	هوهنسون
hoiberg	هوىبرگ
hoitink	هوىتىنك
holcomb	هولكامب
holden	هلدن
holdsworth	هولدزورث
holfelder	هالفلدر
holkner	هولكنر
holland	هولاند
holle	هلى
holliday	هالىدى
hollifield	هالىفىلد
hollinden	هلىندن
hollyman	هولىمن
holm	هولم
holman	هولمن
holmes	هولمز
holroyd	هولروىد
holsten	هولستن
holtlandensis	هلتلندنسىس
holton	هالتون
holtsinger	هالتسىنگر
holtz	هالتز
holub	هالوب
holum	هلوم
holy	هلى
holzen	هولزن
holzgang	هلزگنگ
holzman	هلزمن
holzwarth	هولزوارث
homan	هومن
hon	هن
honig	هنىگ
honigberg	هونىگبرگ
honnur	انور
hooft	هوفت
hoogeveen	هوگوىن
hoogheem	هوقىم
hoogland	هوگلند
hook	هوك
hooper	هوپر
hoos	هوس
hooven	هوون
hoover	هوور
hopcraft	هاپكارفت
hopkins	هاپكىنز
hoppe	هوپ
hopper	هاپر
hopson	هاپسون
horak	هراك
horan	هران
horgan	هورگان
horio	هورىو
horkan	هوركان
horne	هرن
hornecker	هرنكر
horner	هارنر
hornig	هورىنگ
hornsby	هرنسباى
horowitz	هورووىتز
horree	هورى
horrigmo	هورىگمو
horsfall	هرسفال
horst	هورست
hortmann	هورتمن
horvat	هوروات
hosain	حسىن
hoskins	هاسكىنز
hosn	حسن
hoss	هاس
hostetler	هاستتلر
hotopp	هاتاپ
houde	هود
hough	هوگ
houghtailing	هافنىلىنگ
houghten	هاگتن
houghton	هاوتون
houle	هاىول
hourcle	هاركل
hourihan	هورىهان
house	هاوس
houser	هاوسر
houston	هاستون
hovey	هاوى
howarth	هووارت
howe	هو
howell	هاول
howells	هاولز
howerter	هورتر
howes	هوز
hoyman	هوىمان
hrabi	هرابى
hranicky	هرانىكى
hua	هوا
hubein	هابىن
huber	هابر
huck	هاك
huckaby	هاكاباى
huckvale	هاكوىل
huddleston	هادلستون
hudoba	هادوبا
hudson	هادسون
huffman	هافمن
hugdahl	هاگدال
huggard	هوگارد
hugh	هىو
hughes	هوگس
hughson	هاگسون
huhtala	هاهتاها
huigen	هوىگن
huisken	هوىىسكن
huizing	هراىزىنگ
hulan	هالان
hulse	هولس
hultgren	هالتگرن
hume	هوم
humm	هوم
humpherys	هامفرىز
humphrey	هامفرى
humphreys	هوفرىن
hung	هانگ
hungerford	هانگرفورد
hunkler	هانكلر
hunsaker	هانساكر
hunt	هانت
huntington	هانتىنگتون
hurtah	هارتاه
husain	حسىن
husby	هاسبى
husemann	هاسمن
husik	هاسىك
husk	هاسك
hussain	حسىن
hussein	حسىن
hutcheson	هاتچسون
hutchinson	هوچىنسون
hutchison	هاتچىسون
huth	هات
hutter	هاتر
huttley	هاتلى
hutton	هاتون
huyer	هاىر
huyser	هوىسر
hvezda	وزدا
hvinden	وىندن
hyde	هاىد
hyland	هىلند
hyman	هىمن
hynes	هىنز
hyslop	هىسلاپ
hyson	هاىسون
hyunsoo	هىونسو
hyvonen	هاوونن
iain	ىاىن
iarla	ىارلا
ibar	اىبار
ibironke	اىبىرونك
ibrahim	ابراهىم
ibrini	ابرىنى
icarus	اىكاروس
ice	اىس
icefalls	اىسفالز
iceport	اىسپورت
ichiro	اىچىرو
iclozan	اىكلوزان
ida	اىدا
idris	ادرىس
idun	اىدان
idury	اىدورى
ienatch	اىناچ
ierardi	اىراردى
ifo	اىفو
igloo	اىگلو
igoe	اىگو
igor	اىگور
ijuin	اىجوىن
ikbal	اقبال
ike	اىكه
ilan	اىلان
ilana	اىلانا
iler	اىلر
ilia	اىلىا
ilidio	اىلىدىو
ilieve	اىو
iliff	ىلىف
ilkka	اىلكا
ilmin	اىلمىن
ilpo	اىلپو
ilyess	اىلىس
imar	اىمار
inan	اىنان
inanna	اىنانا
inauen	اىناىن
inch	اىنچ
incognita	اىنكوگنىتا
indewey	اىندوى
indiresan	اىنداىرسن
indra	اىندرا
indranil	اىندرانىل
indrelee	اىندرلى
indulis	اىندالىس
ines	اىنس
inez	اىنز
ing	اىنگ
ingalls	اىنگالز
inge	اىنگ
ingegneri	اىنججنرى
ingle	اىنگل
ingles	اىنگلس
inglis	اىنگلىس
ingmar	اىنگمار
ingold	اىنگلد
ingolf	اىنگلف
ingraham	اىنگراهام
ingram	اىنگرام
ingresole	اىنگرىسول
ingrid	اىنگرىد
ingvar	اىنگوار
inho	اىنهو
inman	اىنمن
inna	اىنا
inner	اىنر
innes	اىنس
innocent	اىنوسنت
institut	انستىتو
internet	اىنترنت
interrante	اىنترنت
intyre	اىنتاىر
inzhenery	اىنزهنرى
iowa	اىوا
irbid	اربىد
ireland	اىرلند
irizarry	اىرىزارى
irvin	اىروىن
irwin	اىروىىن
isaac	اىساك
isaacs	اىساكس
isacq	اىساسك
isakson	اىزاكسون
isbell	اىسبل
isecke	اىسك
iselt	اىسلت
ishizaki	اىشىزاكى
isman	اىزمن
israel	اسراىىل
israt	اسراط
isthmus	اىستموس
istian	اىستىن
itamar	اىتامار
itchon	اىتچون
iunn	ىون
ivar	اىوار
ivery	اىورى
ivetic	اىوتىك
iyer	اىر
izadi	اىزدى
izroda	اىزرودا
izzo	اىزو
jaantje	جانته
jabir	جبىر
jack	جك
jackson	جكسون
jacobje	جاكوبه
jacobs	جاكوبز
jacobson	جاكوبسون
jacobsson	جاكوبسون
jacoby	جاكوبى
jacomyntie	جاكامىنته
jacques	جاكوس
jaepje	جاپج
jager	جاگر
jago	جاگو
jahamane	جهامانه
jahmane	جهمانه
jahnke	جانك
jahra	زهرا
jain	جاىن
jakeman	جىكمن
jakobsson	جكوبسون
jalal	جلال
jalonen	جالونن
jamal	جمال
james	جىمز
jameson	جىمسون
jamie	جىمى
jamil	جمىل
jamilah	جمىله
jamulla	جمولا
jan	جان
jana	جنا
janairo	جنىرو
janakiraman	جىناكىرامان
janardhan	جاناردهان
janches	جانچس
janecek	جىنىك
janecka	جانىكا
janes	جىنس
jann	جان
janotje	جانوته
jansje	جانسجه
jansky	جانسكى
janssen	جانسن
jarash	ارش
jarbot	جاربوت
jardine	جاردىن
jarrett	جارت
jarwala	جاروالا
jaschek	جاسچك
jasper	جاسپر
jaspers	جاسپرز
jasvinder	جاسوىندر
jatinder	جاتىندر
javed	جاوىد
javier	جاوىر
jayan	جاىان
jayaram	جاىارام
jaymes	جىمز
jayne	جاىن
jean	جىن
jedi	جدى
jee	جى
jeff	جف
jeffcock	جفكك
jeffrey	ژفرى
jehan	جهان
jeltje	جلج
jelvemark	جلومارك
jen	جن
jenah	جناح
jeng	جنگ
jenings	جنىنگز
jenkinson	جنكىنسون
jenks	جنكس
jennifer	جنىفر
jeppesen	جپسن
jerada	جرادا
jeremias	جرمىاس
jeremic	جرمىك
jeremy	جرمى
jergens	جرگنز
jeronimus	جرونىموس
jesper	جسپر
jesse	جىسه
jessica	جسىكا
jessick	جسىك
jester	جىستر
jesus	جىسوز
jethro	جترو
jetsam	جتسام
jewell	جىووىل
jewett	جوىت
jhang	جهانگ
jia	جىا
jian	جىان
jigang	جىگانگ
jilles	جىلز
jillian	جىلىان
jim	جىم
jiminey	جىمىنى
jin	جىن
jiok	جىوك
jirousek	جىروسك
jitta	جىتا
jizan	جىزن
joab	جواب
joan	جوان
joao	جواو
jobje	جوب
joel	جول
joesph	جوىسف
joffe	جوف
jog	جاگ
johanes	جوهانز
johann	جوهان
johanna	جوهانا
johannes	ىوهانس
johannesen	جوهانسن
johannson	جوهانسون
johansson	جوهانسون
john	ژان
johnny	جانى
johns	جانز
joiner	جوىنر
jokin	جكىن
jolee	جولى
jolene	جلنى
jolliff	جولىف
joltes	جولتز
joly	جولاى
jonas	جوناس
jonathon	جاناتون
jong	جانگ
jongtae	جانگتاىى
jonin	جونىن
jonn	جون
jonsson	ىونسون
joppru	جوپرو
jorge	جورج
jorgen	جورجن
jorritsma	جورىسما
jory	جورى
joseph	جسف
josephus	جوزفوس
josey	جوزى
josh	جاش
josi	جوزى
josie	جوزىه
josip	جوسىپ
joslin	جوسلىن
jost	جاست
jostein	جاستىن
joswig	جوسوىگ
joubb	جوب
joubin	جوبىن
joungane	جونگان
jouni	جونى
joura	جورا
jouravlev	جوراولو
jovica	جاوىكا
jowett	جوىت
joyce	جوىس
joydeep	جوىدىپ
joyner	جوىنر
juana	جوانا
juang	جوانگ
juanita	جوانىتا
juay	جواى
jubal	جوبال
jubb	جاب
jud	جاد
judas	جوداس
judd	جاد
judi	جودى
judy	جودى
juhani	جوهانى
juliaantje	جولىانتجه
jun	جون
june	جون
jung	جانگ
junger	جانگر
junghans	جونگانز
junior	جونىور
junk	جانك
juno	جونو
jurah	جوراه
jurek	جورك
jurgens	جورگنز
jurisica	ژورىسىكا
jurran	جوران
justham	جاستام
justin	جاستىن
justine	جاستىن
justje	جاستجى
justus	جاستاس
juvander	جواندر
juza	جوزا
kabakian	كباكىان
kabakibo	كباكىبو
kabir	كبىر
kacandes	كاكاندس
kaden	كادن
kadin	كدىم
kado	كادو
kadribasic	كادرىبىسىك
kagle	كاگل
kahane	كاهان
kai	كاى
kailas	كاىلاس
kain	كىن
kairoff	كاىروف
kaki	كاكى
kakodkar	كاكدكار
kakure	كاكىور
kalafatas	كالافاتاس
kalafut	كالافوت
kalathur	كالاتور
kalb	كلب
kale	كىل
kaleb	كالب
kalemis	كالمىس
kalia	كالىا
kalila	كالىلا
kalish	كالىش
kalisiak	كالىسىاك
kalkan	كالكان
kalle	كال
kalman	كالمان
kalpak	كالپاك
kalpana	كالپانا
kalpesh	كالپش
kalyan	كالىان
kam	كام
kamal	كامال
kamala	كامالا
kamath	كامات
kamdar	كمدر
kame	كام
kamel	كامل
kamelen	كاملن
kamen	كامن
kamens	كامنس
kamerud	كامرود
kamholz	كامهولز
kamien	كامىن
kamiya	كامىا
kamlish	كاملىش
kammeyer	كمىر
kampe	كامپ
kamper	كامپر
kamphuis	كمفوىس
kamskaya	كامسكاىا
kana	كانا
kanak	كاناك
kanamori	كنامورى
kanda	كاندا
kandell	كندل
kandi	كاندى
kandolf	كندولف
kane	كان
kang	كانگ
kania	كانىا
kannan	كانان
kanter	كانتر
kanze	كانزى
kao	كىو
kaos	كاوس
kapanga	كاپانگا
kapetan	كپتان
kapila	كاپىلا
kapje	كپجه
kaplan	كاپلن
kapner	كاپنر
kapoor	كاپور
kapp	كاپ
kappa	كاپا
kapral	كاپرال
kapson	كاپسون
kara	كارا
karabulut	كارابولوت
karaca	كاراسا
karan	كاران
karas	كراراس
karasu	كاراسو
karayel	كاراىل
karbala	كاربالا
kardal	كردال
kardel	كاردل
kardelis	كاردلىس
karen	كارن
karida	كارىدا
kariger	كارىجر
karim	كرىم
karish	كارىش
karl	كارل
karlquist	كارلكوىست
karlsson	كارسون
karmann	كارمان
karn	كارن
karp	كارپ
karplus	كارپلاس
karr	كر
karras	كاراس
karridian	كارىدىان
kartik	كارتىك
karty	كارتى
karumuri	كرامارى
karwin	كاروىن
kasama	كاساما
kasat	كاسات
kasouf	كاسوف
kasprzak	كاسپرزاك
kassam	كاسام
kassem	كاسم
kassirer	كازىرر
kast	كست
kastein	كاستىن
kastner	كاستنر
kastrup	كستراپ
kasturi	كاستورى
kasun	كاسون
kateb	كاتب
katen	كاتن
kateri	كاترى
kates	كىتس
kathol	كاتل
kati	كاتى
katie	كىتى
katishna	كانىشنا
katleman	كاتلمن
katopis	كاتوپىس
katrin	كاترىن
katrina	كاترىنا
katryntje	كاترىن
katta	كاتا
katwala	كاتوالا
katz	كتز
kauk	كاىك
kave	كاوه
kaveh	كاوه
kavita	كاوىتا
kawai	كاواىى
kaya	كاىا
kayak	كاىاك
kazdan	كازدان
kazi	كازى
kazmaier	كازماىر
kazuhiro	كازوهىرو
kazunori	كازونوزى
kean	كن
keane	كىن
keanini	كىنىنى
keasha	كىشا
keath	كىت
keating	كىتىنگ
keay	كى
keber	كبر
kebir	كبىر
kecheng	كچنگ
keck	كك
kedar	كدر
kee	كى
keebler	كىبلر
keefe	كىف
keegan	كىگان
keelan	كىلان
keele	كىل
keeler	كىلر
keen	كىن
keep	كىپ
keeping	كىپىنگ
kees	كىس
keesee	كىسى
keet	كىت
kehle	كل
kehoe	كهو
kei	كى
keidra	كىدرا
keifer	كىفر
keijo	كىجو
keim	كىم
keinanen	كىنانن
keinknen	كىنكنن
keir	كىر
keiron	كىرون
keithley	كىتلى
kelimoff	كلىموف
kelkar	كلكار
kellar	كلار
keller	كىلر
kellman	كلمن
kellner	كلنر
kellogg	كلاگ
kelly	كلى
keltner	كلتنر
kelvinen	كلوىنن
kemker	كمكر
kemp	كمپ
kemper	كمپر
kempster	كمسپتر
ken	كن
kendall	كندال
kendi	كندى
kendig	كندىگ
kendrick	كندرىك
keng	كنگ
kenn	كن
kennepohl	كنپول
kenner	كنر
kenney	كنى
kenning	كننىنگ
kennington	كنىنگتون
kensingto	كنسىنگتو
kensiski	كنىسكى
kenta	كنتا
kentaro	كنتارو
kenyon	كنىن
kenz	كنز
keong	كونگ
kephart	كفارت
kepley	كپلى
keppel	كپل
kerbel	كربل
keren	كرن
kerger	كرگر
kerien	كرىن
kerila	كرىلا
kerins	كرىنز
kermit	كرمىت
kern	كرن
kernie	كرناى
keromitis	كرومىتس
kerrie	كراى
kerrigan	كرىگان
kershner	كرشنر
kerslake	كرسلىك
kert	كرت
kerwood	كرود
kesavan	كسوان
kesek	كسك
keshav	كشاو
keshavan	كشاوان
keshlan	كشلن
kessler	كسلر
kesson	كسون
kesterson	كسترسون
ket	كت
ketan	كتان
ketcham	كتچام
ketil	كتىل
ketley	كتلى
ketola	كتولا
keulen	كلن
keven	كون
kevin	كوىن
kevran	كوران
kevyn	كوىن
kewitz	كوىىتز
key	كى
keyne	كىن
keyser	كىسر
khalidah	خالداه
khan	خان
kheong	كوانگ
kiat	كىات
kibbe	كىبه
kibler	كىبلر
kibo	كىبو
kick	كىك
kid	كىد
kiddle	كىدل
kief	كىف
kieffer	كىفر
kiehl	كىهل
kiehne	كىنه
kielhorn	كىلهورن
kiely	كىلى
kien	كىن
kiera	كىرا
kieras	كىراس
kieth	كىت
kiggins	كىگىنز
kight	كاىت
kikuma	كىكوما
kilbane	كىلبىن
kilby	كىلباى
kilg	كىلگ
kilgore	كىلگور
killebrew	كىلبرو
killer	كىلر
killermet	كىلرمت
killion	كىلىون
killpack	كىلپك
kills	كىلز
kim	كىم
kimball	كىمبال
kimberey	كمبرى
kimes	كىمز
kimmo	كىمو
kimon	كىمون
kimppa	كىمپا
kimura	كىمورا
kin	كىن
kina	كىنا
kinane	كىنان
kinard	كىنارد
kingery	كىنگرى
kingfai	كىنگفاى
kingsford	كىنگسفورد
kingston	كىنگزتن
kinkade	كىنكىد
kinky	كىنى
kinman	كىنمن
kinnersley	كىنرسلى
kinney	كىنى
kinsell	كىنسل
kinsella	كىنسلا
kinsey	كىنزى
kinsman	كىنمن
kinson	كىنسون
kint	كىنت
kintel	كىنتل
kinyon	كىنىون
kiong	كىونگ
kipp	كىپ
kirby	كىربى
kirill	كرىل
kirin	كرىن
kirishi	كىرىشى
kirk	كىرك
kiser	كىسر
kish	كىش
kislo	كىسلو
kissane	كىسىن
kissinger	كىسىنجر
kitaguchi	كىتاگوچى
kitamura	كىتامورا
kitch	كىتچ
kitchen	كىتچن
kitchin	كىچىن
kitt	كىت
kittel	كىتل
kivivalli	كىوىوالى
kizer	كىزر
klaartje	كلارت
klammer	كلامر
klassa	كلاسا
klassen	كلاسن
klatt	كلات
klausmeier	كلاسمىر
klawiter	كلاوىتر
klee	كلى
kleier	كلىر
klein	كلىن
kleinsorge	كلىنسورگ
klemans	كلمانز
klemmer	كلىمر
klemp	كلمپ
klinck	كلىنك
kline	كلىن
klotz	كلاتز
kloubek	كلوبك
kloukinas	كلوكىناس
klug	كلاگ
klute	كلوته
klyber	كلىبر
knaff	ناف
knapp	ناپ
knauff	ناف
knel	نل
knepper	كپر
kneusel	نوسل
knickerbacker	نىكربىكر
kniffin	نىفىن
knight	كىنت
knippenberg	نىپنبرگ
knispel	نىسپل
knob	كنوب
knoefel	نوىفل
knoell	نوىل
knoke	ناك
knoll	نول
knop	ناپ
knoph	نوف
knox	نوكس
knufinke	كنوفىنكه
knutsen	ناتسن
kobb	كوب
kobben	كوبن
koberg	كبرگ
kobsa	كوبسا
koci	كاسى
kocian	كوشىن
kocourek	كوكورك
koenraad	كونراد
kogias	كوجىاس
koichi	كوىچى
koike	كوىك
kokal	كوكال
kokenge	كوكنج
kokkonen	كوكونن
koktavy	كوكتاواى
kolasa	كولاسا
kole	كل
kolen	كولن
kolichala	كولىچالا
koliha	كولىها
kolkka	كولكا
koller	كولر
kolluri	كالرى
kolodney	كلدنى
kolte	كولت
koma	كما
komorita	كومورىتا
kon	كون
konerding	كنردىنگ
konestabo	كانستابو
kong	كونگ
konganda	كوگاندا
konig	كانىگ
koning	كونىنگ
kono	كونو
konopka	كونوپكا
koolen	كولن
koolish	كولىش
koorapaty	كوراپاتى
koosje	كوسژ
koper	كوپر
kopp	كوپ
koppes	كوپس
kordas	كورداس
kordes	كوردس
korey	كورى
kornele	كورنله
korp	كورپ
korsten	كورستن
korte	كورته
kortright	كورتراىت
kory	كورى
kosenko	كوسنكو
kosinski	كاسىنسكى
koslov	كوسلو
kosmicki	كاسمىچى
kossack	كوساك
kosta	كوستا
kostelak	كستلاك
kosten	كوستن
koster	كاستر
kostis	كوستىس
kosuge	كوسوگه
kotla	كوتلا
kotte	كتى
kottmeier	كوتماىر
kou	كو
kouba	كوبا
koukalik	كوكالىك
kousky	كوسكى
kovalcik	كوالسىك
kovar	كووار
koven	كاون
kowal	كوال
kowalik	كوىالىك
kowalski	كوىالسكى
kowitt	كوىت
kozo	كوزو
kraack	كراك
kraaij	كراىج
krab	كراب
krasen	كرازن
krasic	كراسىك
krasner	كرسنر
krasnow	كرسنو
krattiger	كراتىگر
kratzer	كراتزر
kre	كره
krebser	كربسر
krech	كرچ
krelius	كرلىوس
krenn	كرن
krenz	كرنز
kresh	كرش
kresna	كرزنا
kress	كرس
kresten	كرستن
kretzer	كرتزر
kreuer	كروىر
krieg	كرىگ
krieger	كرىگر
kriger	كرىگر
kriman	كرىمن
kris	كرىس
krishan	كرىشان
krisje	كرىسجه
krisoijn	رسىوىن
krissy	كرىسى
krister	كرىستر
kristian	كرىستىن
kristijntje	كرىستىنتى
kristin	كرىستىن
kristina	كرىستىنا
kristine	كرىستىن
kristler	كرىستلر
kriston	كرىستون
kristopher	كرىستوفر
krob	كروب
krok	كروك
kromann	كرومن
kromer	كرومر
kropik	كروپىك
kroum	كروم
krug	كروگ
kruk	كراك
krumm	كروم
kruschen	راسچن
kube	كاب
kubla	كوبلا
kubo	كوبو
kucera	كوسىرا
kuchar	كوچار
kuchling	كاچلىنگ
kudlacek	كادلاسك
kudreikis	كادرىكىس
kuin	كوىن
kuiper	كوىپر
kukulies	كىوكىولىس
kulbida	كالبىدا
kuldell	كالدل
kulesh	كولش
kullmann	كالمن
kumar	كىومر
kummer	كامر
kundu	كاندو
kunst	كانت
kupec	كاپك
kuper	كوپر
kurger	كرگر
kurilla	كورىلا
kurke	كرك
kursun	كورسن
kurt	كارت
kushay	كوشاى
kushnir	كاشنىر
kusterman	كوسترمن
kusumoto	كىوسماتو
kutz	كوتز
kuwayt	كوىت
kuyper	كاىپر
kwa	كوا
kwan	كوان
kwast	كواست
kwong	كوانگ
kyle	كاىل
kyrus	كاىراس
kyte	كاىت
laakso	لاكسو
laan	لان
labatt	لابات
labdon	لبدون
labelle	لابل
laberge	لىبرگ
labore	لبور
labrinidis	لبرىنىدىس
labriola	لابرىولا
labroad	لابراد
lacelle	لاكله
lachance	لاچنس
lachlan	لاچلن
lackey	لاكى
lacoste	لكوست
lacouture	لاكوتوره
lacross	لكروس
lacy	لىسى
ladak	لدك
ladasky	لاداسكى
lade	لىد
lademann	لىدمان
ladeuil	لادىوىل
ladic	لادىك
ladonne	لادون
ladwig	لادوىگ
laffey	لافى
lafountaine	لافاونتىن
lafourcade	لافوركاد
lagerberg	لاجربرگ
lagerling	لاگرلىنگ
lagomorph	لاگوموروف
lagoon	لاگون
lahelma	لاهلما
lahij	لهى
lai	لاى
laiho	لاىهو
laine	لىن
laing	لاىنگ
laird	لاىرد
lakewood	لاكوود
laky	لاكاى
lal	لال
lalit	لالىت
laly	لالى
lam	لام
lamark	لامارك
lamastus	لاماستوس
lambda	لامبدا
lamboley	لامبولى
lamborn	لمبورن
lambourne	لامبورن
lambros	لامبروس
lamers	لمرز
lamm	لام
lammers	لامرس
lamorce	لامورس
lamp	لمپ
lampi	لامپى
lamping	لمپىنگ
lampitt	لامپىت
lamplight	لامپلاىت
lamykin	لامىكىن
lan	لان
lana	لانا
lance	لانس
lancetes	لانستز
land	لاند
landahl	لنداهل
landauer	لنداور
landers	لاندرز
landi	لندى
landin	لندىن
landis	لاندىس
landman	لاندمن
landon	لاندن
landry	لندرى
lands	لندز
lanett	لانت
lanetta	لانتا
langdon	لانگدون
lange	لانج
langley	لانگلى
langmaid	لنگمىد
langmead	لنگمىد
langseth	لنگسث
langston	لنگستون
lani	لانى
lanka	لانكا
lankton	لانكتون
lann	لان
lanner	لانر
lannie	لانى
lannom	لانوم
lanterman	لانترمان
lantlosamade	لانتلوساماد
lantz	لانتز
lanusse	لانوسى
lao	لاىو
lap	لپ
lapaso	لاپاسو
lapham	لافام
lapidary	لاپىدارى
laporta	لپورتا
laputa	لاپوتا
lapworth	لاپورت
lara	لارا
laralee	لارالى
lareef	لارىف
larga	لارجا
large	لارج
larissa	لارىسا
laroche	لاروچ
larocque	لاروكوىه
larren	لارن
larson	لارسون
larter	لارتر
larue	لارو
larurel	لارورل
las	لاس
lascala	لاسكالا
laser	لىزر
lash	لاش
lashley	لشلى
laska	لاسكا
laskos	لاسكوس
lasnik	لاسنىك
last	لاست
lastra	لاسترا
latala	لاتالا
lathbury	لاتبرى
latta	لاتا
lau	لى
lauener	لانر
laura	لورا
laurent	لورنت
lauritsen	لاىورىتسن
laursen	لارسن
lauverjat	لوورجات
lavalie	لوالاى
lavigne	لاوىن
lavonius	لاونىوس
law	لاو
lawande	لاوانده
lawless	لاولس
lawrance	لارنس
lawrence	لاورنس
lawrie	لورى
lax	لكس
lazara	لازارا
lazard	لازارد
lazzaro	لازارو
lea	لىا
leach	لىچ
leahy	لىهى
leair	لىر
leake	لىك
leason	لىسن
leatherock	لىدراك
lebed	لىبىد
lebel	لىبل
leben	لبن
lebon	لبون
lebrun	لىبرن
lechelle	لچله
lechmere	لچمر
leckie	لكى
lecomber	لكامبر
lecren	لكرن
lection	لكشن
ledford	لدفورد
ledge	لدج
ledwidge	لدواىدج
lee	لى
leeder	لىدر
leeuw	لىو
lefaive	لىفاىو
leff	لف
leffler	لفلر
legg	لگ
lehan	لهان
lehle	لهله
lehman	لهمان
lehmann	لهمن
lehnerer	لهنرر
lehnert	لنرت
lehrian	لهرىان
lei	لى
leibowitz	لىبوىتز
leiderdorp	لىدردورپ
leighton	لىتون
leila	لىلا
leinonen	لىنونن
lemon	لمون
lence	لنس
lendino	لندىنو
lendl	لىندل
lendvai	لندواى
lengeling	لنگلىنگ
lenkei	لنكى
lennon	لىنان
lentin	لنتىن
leonard	لىونارد
leonardo	لىوناردو
leonora	لىنورا
lepage	لىپىج
lepard	لپارد
leppart	لپارت
leppla	لپلا
lerbs	لربز
lerman	لرمن
lesesne	لىسىن
lesher	لشر
lesht	لشت
lesiak	لسىاك
lesion	لىزن
lessard	لسارد
lesser	لسر
leto	لتو
levavy	لىوىوى
levi	لوى
levine	لىوىن
levinson	لوىنسون
leviseur	لوىسىور
lewendon	لوىندن
lewin	لوىن
lewis	لوىس
ley	لى
leybourne	لىبورن
leythen	لىدن
leyton	لىتون
liam	لىام
lian	لاىان
lianez	لىانز
liang	لىانگ
liao	لىاو
liau	لىو
libannord	لىبانورد
liberchuk	لىبرچاك
liberty	لىبرتى
libes	لاىبز
liblit	لىبلىت
librik	لىبرىك
licharson	لىچارسون
lichorowic	لىچوروىىس
lichten	لىچتن
lidal	لىدال
lidwina	لاىدوىنا
lie	لى
liebchen	لىبچن
liebman	لىبمن
liebson	لىبسن
lien	لىن
lier	لىر
lieuwe	لىووه
liewe	لىو
lightburn	لاىتبرن
lightman	لاىتمن
lightning	لاىتنىنگ
ligne	لاىن
likes	لاىكز
lila	لىلا
lilback	لىلبك
lilienthal	لىلىنتال
lilley	لىلى
lim	لىم
limace	لاىماك
limb	لاىمب
limbach	لىمباخ
limburg	لىمبورگ
liming	لىمىنگ
limmer	لىمر
lin	لىن
linares	لىنارس
lincoln	لىنكلن
lind	لىند
lindal	لىندال
lindback	لىندبك
lindberg	لىندبرگ
linde	لاىند
lindemann	لىندمن
linden	لىندن
lindenmuth	لىندنموت
linderman	لىندرمن
lindgard	لىندگارد
lindgren	لىندگرن
lindholm	لىندهلم
lindman	لىندمن
lindroth	لىندروتس
lindsey	لىندزى
lindvall	لىنوال
linehan	لىنهان
lingus	لىنگاس
link	لىنك
linkous	لىنكوىس
linstruth	لىنسترات
lionel	لىونل
lions	لىونز
liow	لىو
lipkin	لىپكىن
lippard	لىپارد
lipset	لىپست
liquori	لىكىورى
liren	لىرن
lisa	لىزا
liscano	لىسكانو
lisken	لىسكن
liskey	لىسكى
lison	لىسون
lissa	لىزا
lister	لىستر
liston	لىستون
litchfield	لىچفىلد
litel	لىتل
litt	لىت
littleton	لىتلتون
littmann	لىتمن
littrell	لىترل
litvin	لىتوىن
livengood	لىونگود
livesay	لاىوساى
livian	لىوىن
livingston	لىوىنگستون
liviu	لىوىو
livius	لىوىوس
liz	لىز
lizard	لىزارد
lizards	لىزاردز
loarie	لورى
loats	لواتس
lobb	لاب
lobo	لوبو
lobser	لابسر
loc	لاك
loch	لوچ
lock	لاك
lockard	لوكارد
locker	لاكر
lockshin	لاكشىن
loco	لوكو
lodder	لادر
lodewijk	لدوىك
lodge	لاج
lodman	لودمن
lofaro	لوفارو
lofaso	لوفاسو
lofstrom	لوفستروم
loftus	لفتوس
logendra	لوگندرا
loges	لوگز
logic	لوجىك
lohrentz	لهرنتز
loiselle	لوىىسالى
loizzo	لوىىزو
lok	لوك
loken	لوكن
lomas	لوماس
lombard	لامبارد
lombardo	لامباردو
lommel	لومل
lon	لان
londre	لاندر
lonely	لونلى
lones	لونز
long	لانگ
longshaw	لانگشا
longstaff	لانكستاف
longyear	لانگىر
lonkart	لانكارت
lonn	لون
lonnemo	لونمو
lonnie	لونى
lonningdal	لونىنگدال
lonsdale	لانسدىل
loo	لو
loofburrow	لوفبارو
look	لوك
loop	لوپ
loosmore	لوسمور
lopez	لوپز
lopp	لاپ
lopresti	لوپرستى
lorch	لورچ
lord	لورد
loreena	لورنا
loren	لورن
lorentzen	لورنتزن
lorenz	لورنز
lorenzen	لورنزن
lorenzi	لورنزى
lorenzo	لورنزو
lorgio	لورجىو
lori	لورى
lorton	لورتون
lory	لورى
los	لوس
losantos	لوسانتوس
losecco	لوسسكو
losinger	لاسىنگر
losito	لوسىتو
losset	لوست
lotempio	لوتمپىو
lotridge	لترىج
lott	لات
louboutin	لوبوتىن
loud	لاود
loughe	لوگه
lounsbery	لىونسبرى
louvet	لووت
lovera	لوورا
lovitt	لاوىت
lovstad	لاوستاد
low	لو
lowman	لومن
lownie	لونى
loyd	لوىد
lozano	لوزانو
lozier	لوزىر
lubkin	لابكىن
lucas	لوكاس
luce	لاك
lucero	لوسرو
lucey	لوسى
luchini	لاچىنى
lucie	لوسىه
lucy	لاكى
ludorf	لودورف
ludovicus	لودوىكوس
luinge	لوىىنگه
luk	لوك
luke	لوك
lukes	لوكس
lukka	لوكا
lulkin	لالكىن
lum	لوم
lumbley	لامبلى
lund	لاند
lundager	لانداگر
lundberg	لاندبرگ
lundeen	لاندىن
lundell	لاندل
lundgren	لاندگرن
lundquist	لاندكوىىست
lundstrom	لانداستروم
lung	لانگ
lunsford	لانسفرد
luntz	لانتز
lunz	لونز
lupatkin	لوپاتكىن
luper	لوپر
lupher	لوفر
lupien	لوپىن
luppescu	لاپىسكو
lurie	لورى
luster	لوستر
lustig	لاستىنگ
lustri	لاسترى
lusty	لوستى
luther	لوتر
lutins	لوتىنز
lutkins	لاتكىنز
luttbeg	لوتبگ
lutz	لوتز
lydea	لىدا
lydia	لىدىا
lye	لاى
lyell	لىىل
lylah	لىلا
lyle	لاىل
lymn	لىمن
lyn	لىن
lyndel	لىندل
lynds	لىندز
lynn	لىن
lynne	لىنه
lyric	لىرىك
lyrical	لىرىكال
lysbethje	لىسبتج
lytle	لىتلى
lyubovny	لىوبونى
mabanag	ماباناگ
macaraeg	ماكاراىگ
macauley	ماكاىولى
macdonald	مكدونالد
macek	ماكك
macfarlane	مكفارلىن
macgowan	مكگووان
mach	ماخ
machine	ماشىن
machteld	مچلد
macisaac	ماكىساك
mack	مك
mackay	ماكى
mackerras	ماكىراس
mackinnon	ماكىنون
macko	ماكو
macky	مكى
maclachlan	مىكلاچلن
maclaren	مكلارن
maclean	مكلىن
macmahon	مكماهون
macmillan	مكمىلان
macneil	مكنىل
macomber	ماكومبر
maconochie	ماكونوچى
macra	مكرا
macrae	مكراى
macready	مكردى
macrone	مكرون
macsen	مكسن
mactavish	مكتاوىش
macucci	ماكوسى
macvoy	مكوى
madaba	مدابا
madah	مده
madden	مادن
maddi	مادى
maddison	مدىسون
maddux	ماداكس
madej	مادج
madeleine	مادلىن
madeline	مادلىن
madelyn	مادلىن
madeo	مادىو
mader	مىدر
maderer	مدرر
madinat	مدىنه
madis	مادىس
madison	مدىسون
madon	مادون
madrone	مادرون
mads	مدس
madsen	مدسون
madurai	مادوراى
maffray	مافرى
magagna	ماگاگنا
magda	مگدا
magdaleentje	مكدالن
magee	مگى
mager	ماگر
magesh	مگىش
maggard	ماگارد
maggi	مگى
maggie	مگى
maggs	ماگس
magic	مژىك
magical	مجىكال
magill	ماگىل
maginel	مگىنل
magion	مژىون
magliaro	ماگلىرو
maglott	مگلات
magnan	مگنان
magnuson	مگناسن
magruder	ماگرودر
maguire	ماگوىر
mah	مه
maha	ماها
mahadevan	مهادوان
mahajan	ماهاجان
mahaly	ماهالى
mahault	ماهالت
mahto	ماهتو
mahwit	مهوىت
mai	مى
maimone	ماىمون
main	مىن
maine	ماىن
mains	مىنز
mainwaring	مىنوارىنگ
mair	مىر
maitawa	مىتاوا
maj	مج
majdal	مجدل
majee	ماجى
majere	مىجرى
majid	مجىد
majoe	ماجو
mak	ماك
makil	مكىل
makuch	مكوچ
malamood	مالامود
malan	مالان
malay	ملى
malberg	مالبرگ
malcolm	ملكولم
malde	مالد
malibu	ملىبو
malini	ملىنى
mallick	مالىك
malnar	مالنر
malone	مالونى
malpartida	ماپارتىدا
malte	ملته
maltin	مالتىن
mama	ماما
mame	ممه
mammen	مامن
mana	مانا
manager	منىجر
manama	ماناما
manber	مانبر
manca	مانكا
mancus	مانكوس
mancuso	منكىوس
manda	ماندا
mandal	ماندال
mandaville	مانداوىل
mandel	ماندل
mandible	مندىبل
mandl	مندل
mandle	مندل
mandy	مندى
mane	منه
manetta	مانتا
manfull	منفول
mangin	مانگىن
mangione	منجىون
manglani	مانگلانى
mangus	منگس
mani	مانى
manija	مانىجا
manin	منىن
manish	مانىش
maniskas	مانىسكاس
manjeet	مانجىت
manjit	مانجىت
manley	مانلى
mann	مان
manna	مانا
manning	مانىنگ
mannix	مانتىكس
manno	مانو
manns	مانز
mano	مانو
manoli	مانولى
manolo	مانولى
manoury	مانورى
mansa	منسا
manson	مانسن
mansoor	منصور
mansour	منصور
mansur	منصور
mantey	مانتى
manti	منتى
mantle	منتل
mantor	مانتور
mantsinen	منتسىنن
manu	مانو
many	منى
mao	ماو
maohai	ماىوهاى
maples	ماپلز
mapple	مپل
maqsood	مقصود
mar	مار
maranda	مرندا
marani	مارانى
marat	مارات
marazas	مارازاس
marbach	مارباچ
marc	مارك
marcel	مارسل
marcela	مارسلا
marcelino	مارسلىنو
marcelo	مارسلو
march	مارچ
marchington	ماركىنگتون
marchiondo	مارچىندو
marco	ماركو
marcos	ماركوس
marcum	ماركوم
marcus	ماركوس
marcy	مارسى
marder	ماردر
mares	مارس
margarietie	مارگارىتى
margarietje	مارگرىته
margolin	مارگولىن
margretha	مارگالتا
margrietje	مارگارىتج
margulieux	مارگولىوكس
maria	مارىا
mariani	مارىىانى
mariano	مارىانا
maricondo	مارىكاندو
marijken	مارىكن
marin	مارىن
marino	مارىنو
mario	مارىو
maritje	مارىتج
marius	مارىوس
mark	مارك
markey	ماركى
markham	ماركهام
markiel	ماركىل
markku	ماركو
markowitz	ماركوز
marksteiner	ماركستىنر
marla	مارلا
marlatt	مارلات
marley	مارلى
marlin	مارلىن
marocchi	ماروچى
maroney	مرنى
maroon	مارون
marques	ماركوس
marquette	ماركوىت
marqueza	ماركوىزا
marregante	مارىگانته
marritje	مارىت
marrone	مارون
marrs	مارس
marshall	مارشال
marston	مارستون
marten	مارتن
martens	مارتىنز
marthinus	مارتىنز
marti	مارتى
martijn	مارتىن
martijntje	مارتىنج
martino	مارتىنو
martins	مارتىنز
martinsen	مارتىنسن
marty	مارتى
martyn	مارتىن
martyntje	مارتىنته
martz	مارتز
marv	مارو
marvin	ماروىن
marvit	ماروىت
marwah	مرواح
marwaha	مارواها
marwin	ماروىن
marx	ماركس
marxen	ماركسن
mary	مارى
maryanne	مارىان
marylynn	مارىلىن
maryse	مارىز
marz	مارز
marzec	مارزك
masalkhi	مسالخى
masao	ماساىو
masaru	ماسارا
masataka	ماساتاكا
masato	ماساتو
mascari	ماسكارى
mascias	ماسكىاس
masek	ماسك
mashburn	مشبارن
mashtare	ماشتىر
masin	مسىن
maskell	ماسكل
maslin	مسلىن
masna	ماسنا
masnaa	ماسنا
masoner	مىسونر
masselli	ماسللى
masserman	ماسرمن
massimo	ماسىمو
massios	مسىوس
masson	ماسون
mast	مست
mastan	مستان
masten	ماستن
masters	مسترز
masud	مسعود
mat	مت
matako	ماتاكو
matana	متانا
matar	ماتار
mateen	متىن
matejka	ماتجكا
mathai	ماتاى
matheis	ماتىس
matheson	متسون
mathew	متىو
mathur	ماتور
matin	متىن
matlin	متلىن
maton	مىتون
matrow	مترو
matsuda	ماتسودا
matsumoto	ماتسوموتو
matt	مت
matthew	ماتىو
matthewson	متىوسون
mattis	ماتىس
mattson	ماتسون
mattu	ماتو
matula	ماتولا
matyas	متىوس
mau	ماو
mauer	ماور
maumee	مامى
maupin	ماوپىن
mauro	مورو
maurstad	مورستاد
maury	مرى
mautino	ماتىنو
mavers	ماورس
maw	ماو
mawby	موباى
mawk	ماك
maxi	ماكسى
maxim	ماكسىم
maximilian	ماكسىمىلىان
maximov	مكسىمو
maxwells	ماكسول
may	مى
maycock	مىكوك
mayeen	ماىن
mayerfeld	مىرفلد
maynard	مىنارد
mayne	مىن
mayo	ماىو
mayr	ماىر
maysan	مىثان
maytag	ماىتاگ
mazdeh	مزده
maze	مىز
mazera	مازرا
mcardle	مكاردل
mccann	مككان
mccarthy	مككارتى
mccarty	مككارتى
mccauley	كاولى
mccown	مككاون
mccracken	مككركن
mcdermott	مكدرموت
mcdonald	مكدونالد
mcfarland	مكفارلند
mcfarlane	مكفرلىن
mcgavin	مكگاوىن
mcgeary	مكگىرى
mcgrath	مكگرات
mcguire	مكگوىر
mcguirk	مكگوىرك
mchenry	مكهنرى
mckenna	مككنا
mckenzie	مككنزى
mclean	مكلىن
mcloughlin	مكلاولىن
mcmahan	مكماهان
mcmahon	مكماهون
mcmanis	مكمانىس
mcmullen	مكمولن
mcneill	مكنىل
mcnutt	مكنات
meagher	مىگر
meaker	مىكر
mean	مىن
meaney	مىنى
meara	مىرا
mears	مىرز
measat	مىسات
mecca	مكا
medawar	مداور
medea	مىدى
median	مدىن
medina	مدىنه
medlin	مدلىن
mednick	مدنىك
medrek	مدرك
meechan	مىچان
meehan	مىهان
meek	مىك
meekins	مىكىنز
meeks	مىكز
meewes	مىوس
meger	مگر
megyesi	مگىسى
mehl	مهل
mei	مى
meier	مىىر
meighen	مىگن
meindert	مىندرت
meiners	مىنرز
mejia	مجىا
mekkah	مكه
melander	ملاندر
melanie	ملانى
melara	مىلارا
melby	ملباى
melcher	ملچر
meleedy	ملىدى
melen	مىلن
melka	ملكا
mella	ملا
mellin	ملىن
mellinger	ملىنگر
mellor	ملر
melman	ملمن
melo	ملو
menard	مىنارد
mendell	مندل
mendes	مندز
mendoza	مندوزا
mendyke	مندىك
menes	مىنز
menestrina	منسترىنا
menezes	منزس
meng	منگ
menhardt	منهارت
menke	منك
menth	منت
mentzer	منتسر
menzies	منزىز
meranda	مراندا
mercer	مرسر
merchant	مركنت
meredith	مىرىدىت
meritt	مرىت
merkel	مركل
merkle	مركلى
merolle	مىرول
merrick	مرىك
merricks	مرىكس
merrigan	مرىگان
merriman	مرىمان
merry	مرى
mertens	مرتنز
merz	مرز
mesa	مىسا
mesander	مساندر
meskes	مسكس
messer	مسر
messina	مسىنا
messinger	مسىنگر
mest	مست
metzger	متزگر
metzing	متزىنگ
meuser	مىوزر
meyer	ماىر
meyers	مىرز
miao	مىاو
micha	مىچا
michaelis	مىكاىىلىز
michalak	مىكالك
micheltjen	ماىكلژن
mickelson	مىكلسون
mickhael	مىكاىىل
micklem	مىكلم
mickna	مىكنا
micohn	ماىكوهن
middlebro	مىدلبرو
middleton	مىدلتن
miehe	مىىه
mierwa	مىروا
miettunen	مىتونن
might	ماىت
mighty	ماىتى
mignerey	مىگنرى
migneron	مىگنران
miguel	مىگوىل
mihalick	مىهالىك
mikael	مىكاىل
miket	مىكت
mikkelsen	مىكلسن
mikko	مىكو
mikolic	مىكولىك
mikoss	مىكاس
mikus	مىكس
milacic	مىلاسىس
milad	مىلاد
milam	مىلام
mildred	مىلدرد
milestone	مىلستون
milgram	مىلگرام
milind	مىلىند
milko	مىلكو
milks	مىلكس
milky	مىلكى
millan	مىلان
millar	مىلار
millennium	مىلنىوم
miller	مىلر
millett	مىلت
milley	مىلى
millham	مىلام
milli	مىلى
millians	مىلىانز
millican	مىلىكن
millie	مىلى
millman	مىلمان
milmoe	مىلمو
milne	ماىلن
milner	مىلنر
milnor	مىلنور
milo	مىلو
milos	مىلوس
milt	مىلت
milton	مىلتون
milward	مىلوارد
mimas	مىماس
mime	مىمى
min	مىن
mina	مىنا
minamo	مىنامو
minarik	مىنارىك
mincer	مىنسر
mincey	مىنسى
miner	ماىنر
mineral	مىنرال
minerva	مىنروا
mingo	مىنگو
minna	مىنا
minqi	مىنكى
minstrel	مىنسترل
mintaqah	منطقه
minter	مىنتر
mintz	مىنتز
minyard	مىنىارد
mir	مىر
miranker	مىرانكر
mirashi	مىرشى
mire	ماىر
mirmak	مىرماك
mirti	مىرتى
mirut	مىروت
miskin	مسكىن
mislove	مىسلاو
misra	مىسرا
missal	ماىسال
missel	ماىسل
mistick	مىستىك
mistry	مىسترى
mitchell	مىچل
mitchem	مىتچم
mitham	ماىتهام
mitnick	مىتنىك
mito	مىتو
mitrovic	مىترووىك
mitu	مىتو
miura	مىرا
mix	مىكس
mize	مىز
mizera	مىزىرا
mockridge	ماكرىج
mod	مود
moffat	موفاد
moganti	موگانتى
mogged	ماگد
moghrabi	مقربى
mohan	موهان
mohar	موهر
moile	موىل
mok	موك
molaire	ملاىىر
molander	مولاندر
molinari	مولىنارى
moll	مول
moller	مولر
molloy	مولوى
monack	موناك
monaco	موناكو
moncur	مونكار
mondfrans	موندفرانس
mondor	ماندار
mondore	موندور
money	مانى
monger	مانگر
monk	مونك
monkey	مانكى
monks	مونكز
monroe	منرو
monster	مانستر
monta	مونتا
montag	مونتاگ
montagu	مونتاگو
montalbano	مونتالبانو
montanaro	مونتانارو
montano	مونتانو
montero	مونترو
montijo	مونتىجو
montoya	مونتوىا
montreal	مونترال
montrose	مانتراس
moody	مودى
moon	مون
moore	مور
moorhouse	مورهاوس
moorman	مورمان
mooseface	موسفىس
moqbara	مقبره
morabito	مورابىتو
moraines	موراىنس
morales	مورالس
moran	موران
morando	موراندو
morano	مورانو
moras	موراس
moray	موراى
morch	مورچ
morehouse	مورهاوس
morel	مورل
mores	مورس
morey	مورى
morin	مورىن
morison	مورىسون
morita	مورىتا
morken	موركن
morlan	مورلان
morley	مورلى
morlidge	مورلىج
morning	مورنىنگ
moroney	مورونى
morreale	مورال
morrell	مورل
morrill	مورىل
morse	مورس
morss	مورس
mortimer	مورتىمر
mortimore	مورتىمر
morton	مورتن
morville	موروىل
moses	موزز
moshier	موشىر
mossburg	ماسبرگ
mossman	موسمن
motor	موتور
motors	موتورز
mott	موت
motta	موتا
moudgill	مودگىل
moulden	مالدن
mouli	مولى
moulk	مولك
mountains	مانتنز
mounzer	منزر
mouser	ماوسر
moye	موى
moyer	ماىر
moynes	موىنز
moynihan	موىنىهان
mozina	موزىنا
mubarak	مبارك
mudie	مودى
mueller	موالر
muenzer	موانزر
muenzler	مونزلر
muessig	موسىگ
muffin	مافىن
muh	مو
muhamma	موهاما
muharraq	معرق
muise	موىس
mukasa	موكاسا
muller	مولر
mulligan	مالىگان
mulrooney	مالرونى
mumford	مامفورد
mummert	مامرت
mun	مون
munch	مانخ
muniz	مونىز
munkert	مانكرت
muno	مانو
munoz	موناز
munro	مونرو
muns	مونس
munsil	مانسىل
munsinger	مانسىنگر
mura	مورا
murali	مارالى
muralt	مورالت
murdoch	مورداك
muren	مارن
murie	مارىه
murphy	مارفى
murrell	مورل
murthy	مورتى
mury	مارى
muschall	موشال
muse	موس
musella	موسلا
muthanna	موتانا
mutiso	موتىسو
mutlu	ماتلو
mutt	مات
muysson	موىسون
myer	ماىر
myiesha	ماىشا
myreen	ماىرن
myrick	ماىرىك
mystic	ماىستىك
myth	ماىت
nabatiye	نباتاى
nabil	نابىل
nadig	نادىگ
nadkarni	ندكارنى
nafeeza	نفىضا
nagasaki	ناگاساكى
nagasiva	ناگاسىوا
nager	ناجر
nagy	نگى
nahnah	نهنه
nahum	ناهام
naidoo	ناىدو
naimah	نىما
najaf	نجاف
najiyah	ناجىاه
najwa	نجوا
najya	ناجىا
nakagaki	ناكاگاكى
nakamura	ناكامورا
nakashima	ناكاشىما
nakasora	ناكاسورا
nallick	نالىك
namazi	نمازى
nan	نان
nance	نانس
nancy	نانسى
nandwani	ناندوانى
napolitano	ناپولىتانو
napora	نپورا
napton	ناپتون
naquin	ناكوىىن
nardi	ناردى
nardo	ناردو
nardone	ناردن
narla	نارلا
naro	نارو
narsavage	نارساواگ
nas	ناس
nashida	نشىدا
nashwa	نشوا
nasira	نسىرا
nass	ناس
nassau	ناساو
nathan	نادان
nathanson	نادانسون
nathifa	نتىفا
national	نشنال
nau	ناو
naunton	نانتون
navas	ناواس
nave	ناو
navia	ناوىا
navis	نوىس
nawar	ناوار
nawaz	نواز
nayar	نىر
nayfeh	ناىفه
naylor	ناىلر
nazaretian	نازارىتىان
nazario	نازارىو
nazirah	نزىرا
nebel	نبل
nebres	نبرس
neden	ندن
nedin	ندىن
nedved	ندود
needles	نىدلز
neelmegh	نىلمگ
neeltje	نىلته
nefedow	نفدو
negative	نگتىو
neill	نىل
neisen	نىسن
nelkin	نلكىن
neri	نرى
nery	نرى
ness	نىس
nethacker	نتاكر
netherton	نترتون
neuen	نىوان
neuhaus	نهاوس
neuman	نىومان
nevejans	نوجنانس
nevel	نول
nevile	نواىل
nevison	نىوىسون
newark	نىوارك
newberry	نىوبرى
newbery	نىوبرى
newby	نىوباى
newcomb	نىىوكامب
newington	نوىنگتون
newland	نىولند
newman	نىومن
newquist	نىوكوىست
newsham	نىوشام
newton	نىوتن
nibby	نىبى
nic	نىك
nicholas	نىچولاس
nicholls	نىكلز
nichols	نىكلس
nicholson	نىكلسون
nickel	نىكل
nickell	نىكل
nickelsen	نىكلسن
nickerson	نىكرسون
nickey	نىكى
nicki	نىكى
nicko	نكو
nickolay	نىكولى
niclas	نىكلس
nicol	نىكل
nicola	نىكولا
nicolaes	ناىكولاس
nicolas	نىكولس
nicolaus	نىكلاس
nicole	نىكل
nicoll	نىكول
nicolo	نىكلو
nid	نىد
nidal	نىدال
niek	نىك
niekolaas	نىكلاس
niel	نىل
niels	نىلس
niemi	نىمى
nien	نىن
niermann	ناىرمن
nigg	نىگ
night	ناىت
nigra	نىگرا
nihalani	نىهالانى
niki	نىكى
nikki	نىكى
niklas	نكلس
niknaz	نكنز
nikolay	نىكولى
nikolic	نىكولىك
niland	نىلند
niles	ناىلز
nilesh	نىلش
nils	نلس
nilse	نىلس
nilsen	نلسن
nimrod	نىمراد
nimtz	نىمتز
nin	نىن
ninedek	نىندك
ninja	نىنجا
ninnis	نىنس
nino	نىنو
ninoys	نىنوىس
ninstar	نىنستار
nipple	نپل
nippon	نىپان
niss	نىس
nix	ناىكس
nixon	نىكسون
noble	نوبل
noda	نودا
noko	نوكو
nolan	نولان
nolde	نولد
nolf	نولف
noorda	نوردا
norby	نورباى
norcott	نوركات
nordborg	نوردبورگ
nordby	نوردباى
nordenfelt	نردنفلت
nordenstrom	نوردنستورم
nordt	نوردت
noren	نورن
norha	نورها
northorpe	نورتورپ
northrup	نورثراپ
norup	نروپ
norwood	نوروود
nosack	نوساك
nose	نوز
nossum	نسوم
notz	نوتز
novella	نووالا
novik	نووىك
novillo	ناوىلو
novosel	نووسل
noxon	ناكسون
noya	نوىا
noyles	نوىلس
nuding	نودىنگ
nugent	نوجنت
nunis	نونىس
nuri	نورى
nurse	نرس
nuth	نوت
nutt	نات
nyffeler	ناىفلر
nyikos	ناىكس
oakins	اوكىنز
oakley	اوكلى
obadja	اباجا
ober	اوبر
oberdorfer	اوبردورفر
oberheim	اوبرهىم
oberholz	اوبرهولز
oberle	ابرل
oberreuter	ابروتر
obertas	اوبرتاس
oborg	ابرگ
obremski	ابرمسكى
obst	ابست
obstgarten	ابستگارتن
ochs	اوچز
ocker	اوكر
oddy	اوددى
odell	اودل
odonnell	ادانل
odum	اودىوم
odwak	اودواك
office	افىس
officer	افىسر
ogborn	اگبرن
ohalloran	اوهالوران
ohlund	اهلاند
ohmaki	اوماكى
ohman	اهمن
ohmann	اهمان
ohrman	اوهرمن
ojeda	اجدا
oke	اك
okeefe	اكىف
olafson	اولافسون
olah	اولا
oldcorn	اولدكورن
olds	الدز
ole	اولى
olea	الى
olematon	الماتون
olguin	الگاىن
olhsson	السن
olin	الىن
oliva	الىوا
oliveira	الىورىا
olivie	اولىوىه
olivier	اولىوىر
olivola	اولاىوولا
olney	النى
olsen	اولسن
olson	اسلون
olsson	السان
oltmann	التمن
oltz	التز
omaggio	اماگىو
omega	اومگا
ommer	اومر
oneal	انىل
oneill	اونىل
oner	انر
onesty	اونستى
ong	اونگ
onosko	اونوسكو
oostendorp	اوستندورپ
oppedal	اپىدال
oram	ارام
orbi	اربى
orchard	اوچارد
ore	اور
oregan	ارگان
orem	اورم
orfanakis	ارفاناكىس
orfeus	ارفىوس
orford	ارفورد
organ	اورگان
orhan	اورهان
orhun	اورهان
orion	اورىون
oriordan	اورىوردان
orkney	اوركنى
orlando	اورلاندو
orleans	اورلىنز
ormesporden	اورمسپوردن
ormond	ارماند
orourke	اروركه
orpheus	اورفىوس
orrell	ارل
ortiz	اورتىز
orue	اورو
orval	اروال
orville	اوروىل
osborne	ازبورن
osburn	اوزبرن
osen	اوسن
oseven	اوسىون
oshall	اوشال
osku	اسكو
osowski	اسوسكى
ostby	استباى
ostliche	اوستلىچ
ostrander	اوستراندر
ostrin	استرىن
ota	اتا
otaguro	اوتاگورو
otello	اوتلو
otha	اتا
othman	عثمان
otis	اوتىس
oto	اتو
otoosan	اتوسان
ott	اوت
otto	اتو
ottolini	اوتولىنى
oude	اىد
oudekirk	ادكىرك
oued	اواد
ouedraogo	اودرگو
ougouag	اوقواق
ould	الد
oursler	اورسلر
ouzounis	اوزونىس
overdal	اووردال
overpeck	اوورپك
owchar	اوچار
owens	اونز
owl	اول
oxford	اكسفورد
oxley	اوكسلى
oxton	اوكستون
oyarce	اوىارس
ozgur	اوزگور
ozmen	اوزمن
ozuna	ازانا
pablo	پابلو
pace	پىس
pachiano	پاچىانو
pacholke	پاچولكه
pacific	پاسىفىك
packard	پاكارد
packer	پكر
padial	پادىال
padilla	پادىلا
padua	پادوا
padula	پادولا
pagett	پاگت
paglia	پاگلىا
pagliaro	پاگلىىارو
pai	پاى
paiani	پىنى
paige	پاىج
paik	پىك
painter	پىنتر
pais	پىس
paisley	پىزلى
paizis	پىزس
pakala	پاكالا
paks	پاكس
pal	پال
palagyi	پالاگى
palaio	پلىو
palermo	پالرمو
paley	پالى
pallack	پالاك
pallis	پالىس
palmert	پالمرت
pam	پام
pan	پان
panagos	پاناگس
panas	پاناس
pancras	پانكراس
panda	پاندا
pandian	پاندىان
pandit	پاندىت
pandolfino	پاندولفىنو
pane	پىن
panfil	پانفىل
pangborn	پانگبورن
panici	پانىسى
panico	پانىكو
pannon	پانون
panon	پانن
pant	پانت
panton	پنتون
papay	پاپاى
pape	پىپ
paplaskas	پاپلاسكاس
papp	پاپ
pappalardo	پاپالاردو
paquet	پاكوات
paradise	پردىس
parayil	پاراىل
pardes	پاردز
pardington	پاردىنگتون
pardon	پاردن
parent	پرنت
parham	پارهام
pariente	پرىنت
park	پارك
parkin	پاركىن
parks	پاركز
parmar	پارمار
parra	پارا
parratt	پارات
parrish	پارىش
parrone	پرون
parry	پارى
parson	پارسن
parsons	پارسونز
partee	پارتى
parton	پارتون
parvin	پروىن
pascal	پاسكال
pasco	پاسكو
pasko	پاسكو
pass	پاس
passier	پاسىر
pasternak	پاسترناك
pastore	پاستور
patella	پتلا
patetta	پاتتا
pathyil	پتىل
pati	پتى
patience	پىشنس
patil	پاتىل
patkar	پتكر
patocchi	پاتوچى
patric	پاترىك
patrice	پاترىس
patrick	پترىك
patrik	پاترىك
patrizio	پاترىزىو
patroclus	پاتروكلوس
patsy	پتسى
patten	پاتن
patterson	پاترسون
patti	پتى
patty	پتى
pauli	پالى
paulsen	پالسن
paulson	پاىولسون
paultje	پالتج
pavlik	پاولىك
pavol	پاول
pax	پاكس
payette	پىت
payne	پاىنى
paynton	پىنتون
paysan	پىسان
payton	پاىتون
peabody	پىبادى
peade	پىده
peak	پىىك
peaks	پىكز
pearce	پىرس
pearl	پىرل
pearman	پىرمن
pearsen	پىرسن
pearson	پىرسون
peart	پىرت
peasah	پىساه
pease	پىس
peat	پىت
pecenko	پسنكو
pedersen	پدرسون
peed	پىد
peet	پىت
pegg	پگ
pegram	پگرام
peil	پىل
peipp	پىپ
pelham	پلهام
pelkie	پلكى
pellant	پلانت
pelletier	پلتىىر
pelligrini	پلىگرىنى
peloso	پىلازو
pelt	پلت
peltonen	پلتنن
pence	پنس
pendleton	پندلتن
peng	پنگ
pengadu	پنگادو
pennebaker	پنباكر
pennell	پنل
penniman	پنىمان
penny	پنى
pepe	پپه
pepin	پپىن
peppler	پپلر
percival	پرسىوال
perdicaro	پردىكارو
pereckas	پركاس
perel	پرل
perez	پىرىز
perillo	پرىلو
pering	پرىنگ
perini	پرىنى
perkins	پركىنز
perler	پرلر
perley	پرلى
perpk	پرپك
perrault	پرالت
perreault	پرىاولت
perricone	پرىكن
perrin	پرىن
perry	پرى
persson	پرسون
peskin	پسكىن
petcher	پتچر
peters	پىترز
petersson	پىترسون
petit	پوتىت
petite	پوتىت
petitjean	پتىتجىن
petren	پترن
petrich	پترىچ
petro	پترو
petronella	پترونلا
petrovich	پتروىچ
petrow	پىترو
petry	پترى
pettibone	پىتىبون
petto	پتو
petzold	پتزولد
pezaris	پزاراىس
phi	فى
phiaxay	فىاكسى
philip	فىلىپ
philips	فىلىپس
phill	فىل
phillips	فىلپس
philpot	فىلپات
phils	فىلز
phipps	فىپس
phiroze	فىروز
phlux	فىلاكس
phoque	فوكو
phrink	فرىنك
phua	پاو
phuong	فانگ
phylos	فىلوس
piatek	پىاتك
picasso	پىكاسو
piccolboni	پىكولبنى
piche	پىشه
pickel	پىكل
pickrell	پىكرل
pickup	پىكاپ
pieck	پىك
pieper	پىپر
pier	پىر
pieri	پىىرى
piero	پىرو
piers	پىرس
pieter	پىتر
pietje	پىته
pike	پىك
pil	پىل
pilato	پىلاتو
pilewski	پىلوسكى
pillar	پىلار
pillars	پىلارز
pillay	پىلى
pilvio	پىلوىو
pina	پىنا
pinchas	پىنچاز
pinchera	پىنچرا
pindar	پىندار
pinedo	پىندو
pinette	پىنته
ping	پىنگ
pingenot	پىنگنوت
pinkowitz	پىنكووىتز
pinky	پىنكى
pinn	پىن
pinnacle	پىناكل
pinnow	پىنو
pino	پىنو
pins	پىنز
pinson	پىنسون
pinter	پىنتر
pinyan	پىنىان
piomelli	پىوملى
pion	پىون
piotr	پىوتر
piper	پاىپر
pipgras	پىپگراس
piponi	پىپونى
piran	پىران
pirani	پىرانى
pirawat	پىراوات
pirih	پىرى
pirkko	پىركو
piroz	پىروز
pistun	پىستون
pitha	پىتا
pitkow	پىتكو
pitman	پىتان
pitre	پاىتر
pitts	پىتس
pivnick	پىونىك
piziali	پىزىالى
pizolato	پىزولىتو
pizza	پىزا
pizzi	پىزى
pizzini	پىزىنى
plache	پلچ
plack	پلاك
plante	پلنته
plastino	پلاستىنو
plat	پلت
plate	پلىت
plateau	پلاتىو
platform	پلتفرم
plath	پلات
platkus	پلتكوس
plencner	پلنكنر
plinskin	پلىنسكىن
pliskin	پلىسكىن
ploehn	پلوهن
plott	پلات
plummer	پلومر
plunk	پلانك
plyler	پلاىر
poblete	پابلت
pogosyan	پوگوسىان
pohar	پوهار
pohl	پوهل
point	پوىنت
poirier	پوىرىر
poisl	پوىسل
pokorny	پوكورنى
poland	پولند
polant	پولنت
polemitis	پولمىتىس
polepalli	پولىپالى
poling	پولىنگ
polis	پولىس
politte	پولىت
polk	پولك
pollen	پولن
polo	پولو
polowin	پولووىن
polsky	پالسكى
ponder	پاندر
ponds	پاندز
pool	پول
poore	پور
poosala	پوسالا
poot	پوت
popat	پوپات
pope	پاپ
popli	پاپلى
popp	پوپ
poppen	پاپن
poppleton	پاپلتون
porcino	پرسىنو
porco	پوركو
porges	پورجز
porterfield	پورترفىلد
portnoy	پورتنوى
posen	پوسن
posius	پوزىوس
poso	پوسو
post	پست
postill	پوستىل
postma	پستما
potter	پاتر
potts	پاتس
poulakos	پولاكوس
poulos	پولس
poulter	پولتر
poutre	پوترى
pouw	پو
powles	پولز
poynting	پوىنتىنگ
prado	پرادو
prael	پراىل
prague	پراگو
prahl	پراهل
prall	پرال
pram	پرام
pramod	پرامود
pranav	پراناو
pranke	پرانك
prasad	پراساد
prasana	پراسانا
prasen	پراسن
prashant	پراشانت
pratchett	پراچت
prateek	پراتىك
prates	پراتس
pratiksh	پراتىكش
pratt	پرات
prattico	پراتىكو
pratul	پراتول
praveen	پراوىن
preben	پربن
prech	پرچ
prechelt	پرشلت
preedy	پرىدى
preeti	پرىتى
preisler	پرىسلر
premal	پرمال
prentiss	پرىنسس
prescott	پرسكات
prestero	پرسترو
prestrud	پرسترود
pretty	پرىتى
preuss	پرىوس
prevost	پرىوست
pribe	پراىب
pricing	پرىسىنگ
prickett	پرىكت
prickly	پرىكلى
priest	پرىست
priestly	پرىستلى
prime	پراىم
primeau	پرىمو
primero	پرىمرو
primus	پرىمىوس
prince	پرىنس
priotti	پرىىوتى
priscilla	پرىسىلا
pritchard	پرىچارد
private	پراىوىت
priven	پراىون
priya	پرىا
probst	پرابست
progetto	پروگتو
projet	پروجت
promontory	پرومونتورى
prongs	پرانگس
proos	پوروس
prothero	پروترو
protus	پروتوس
provan	پروان
provo	پروو
provost	پرووست
prowell	پراول
pruemmer	پروامر
prupis	پراپىس
prush	پراش
pruy	پروى
pryor	پرىور
psyko	ساىكو
puah	پوا
puckett	پاكت
puelma	پوالما
puga	پوگا
pugh	پاق
pugliese	پوگلىس
pui	پىىو
pulford	پالفورد
pulgar	پولگار
pulido	پالىدو
pulley	پالى
pulliam	پولىىام
pulsifer	پالسىفر
puma	پوما
pumfrey	پومفرى
punch	پانچ
punjabi	پانجابى
punnoose	پونوز
purahoo	پوراهو
puranik	پورانىك
purcell	پارسل
purinton	پىورىنتن
pursell	پرسل
purshottam	پرشاتتام
puryear	پورىر
pusey	پوسى
putkonen	پوتكونن
putz	پوتز
puusaari	پوسارى
pyramid	پاىرامىد
pyziur	پىزىر
qadir	قدىر
qadira	قدىرا
qamar	قمر
qasim	كسىم
quackenboss	كواكنبوس
quainton	كواىنتون
quartzite	كوارتزىته
quasim	كواسىم
quatrain	كواترىن
qubilah	كوبىلا
qudamah	كوداما
quel	كوىل
querin	كوىرىن
quesada	كوسادا
quezon	كىوزون
quickle	كوىىكل
quilici	كواىلىسى
quillin	كوىلىن
quin	كوىن
quinby	كوانباى
quinn	كوىن
quint	كوىنت
quintana	كوىنتانا
quintanar	كوىىنتانار
quist	كوىست
quitt	كوىىت
quoc	كوك
quock	كىوك
quodling	كاودلىنگ
raben	رابن
rabenau	رابناو
rabiah	ربىاه
rabkin	رابكىن
raboel	رابوىل
rabold	رابلد
racecar	رىسكار
rachael	راچل
rachel	راشل
racicot	راكىكوت
rad	راد
radbone	ردبون
radboud	رادبود
radcliff	رادكلىف
radek	رادك
radenburch	رادنبرچ
radenburgerabroek	رادنبرگربروك
rader	رادر
radha	رادها
radhika	رادهىكا
radig	رادىنگ
radjen	راجن
radov	رادوف
radu	رادو
radwa	رادوا
rafa	رافا
rafael	رافاىل
rafal	رافال
rafalko	رافالكو
rafalski	رافالسكى
rafat	رفعت
rafferty	رافرتى
raffin	رافىن
rafi	رافى
rafique	رافىكىو
ragan	رىگان
raghd	رغد
ragland	راگلند
ragle	راگل
ragnar	راگنار
ragnarsson	راگنارسون
ragnvald	راگنوالد
ragsdale	راگسدىل
rahardjo	راهارجو
rahi	راهى
rahimah	رحىمه
rahul	راهول
rai	راى
raicer	رىسر
raidah	رىدا
raile	راىلى
railsback	رىلسبك
raimond	رىموند
raimund	رىموند
rainer	رىنر
raistlin	راىستلىن
raisty	رىستى
raith	رىت
raivo	رىوو
raizel	راىزل
raj	راج
rajas	رجاس
rajat	رجات
rajeev	راجىو
rajender	راجندر
raju	راجو
ralf	رالف
ralph	رالف
ram	رام
rama	راما
rambo	رامبو
ramer	رامر
ramez	رامز
rami	رامى
ramiro	رامىرو
ramm	رام
ramos	راموس
rampling	رمپلىنگ
ramseier	رامسىر
ramsey	رامسى
ramthun	رامتان
rander	راندر
randhol	رندهل
randy	رندى
rane	رىن
ranu	رانىو
rao	راو
raoult	راولت
raqqah	رقاح
raschke	راشكه
rashed	راشد
rashid	راشىد
rashida	رشىده
raskin	راسكىن
raso	راسو
rastin	راستىن
rasu	راسو
rasul	رسول
rat	رت
ratcliffe	رتكلىف
rath	رات
rathmann	راتمن
rau	راو
rauh	راو
rautiala	راىوتىالا
raverdy	راوردى
ravey	راوى
ravi	راوى
raviraj	راوىراج
rawdah	راودا
rawiyah	راوىاه
rawlings	راىولىنگز
ray	رى
rayburn	رىبرن
rayer	رىىر
rayle	راىله
raymond	رىموند
razdan	رازدان
razorback	رازوربك
rbeis	ربىس
reamy	رىمى
reardon	رىردان
rears	رىرز
reaser	رىسر
reasor	رىسور
reavis	رىوىس
rebholz	ربهولز
reboso	ربوسو
rechelle	رشل
reckdahl	ركدال
reckeweg	ركوگ
reddy	ردى
redfield	ردفىلد
redlus	ردلوس
redman	ردمن
redondo	ردوندو
reed	رىىد
reenalda	رىنالدا
reese	رىس
reetz	رىتز
refsnes	رفسنس
refson	رفسون
reg	رج
regard	رىگارد
rehling	رهلىنگ
reidy	رىدى
reierson	رىرسون
reiland	رىلند
reilley	رىلى
reinders	رىندرز
reindert	رىندرت
reinert	رىنرت
reinold	رىنولد
reinoud	رىنود
reiser	رىزر
reisner	رىسنر
reiss	رىس
reissner	رىسنر
reksten	ركستن
remde	رمد
remlinger	رملىنگر
remmen	رمن
remy	رمى
renalds	رنالدز
renaud	رناود
renault	رنالت
rendar	رندر
rennebarth	رنبارت
renvoise	رنوىس
renze	رنز
renzland	رنزلند
replogle	رپلاگل
reppert	رپرت
repton	رپتون
research	رىسرچ
resele	رسل
resnick	رسنىك
resolveert	رىسولورت
resonate	رسونات
rest	رست
retzer	رىتزر
reuber	رىوبر
revelo	رولو
revuluri	روولورى
rey	رى
reyden	رىدن
reyes	رىس
reymont	رىمانت
reynolds	رىنالدز
rheni	رهنى
ribar	رىبار
ribner	رىنر
rich	رىچ
richar	رىچار
richardson	رىچاردسون
richau	رىچاو
richer	رىچر
richey	رىچى
richmeyer	رىچمىر
richolson	رىكولسون
rickard	رىكارد
ricker	رىكر
rickert	رىكرت
ricketts	رىكتز
ricky	رىكى
rida	رىدا
riddle	رىدل
rieb	رىب
riedel	راىدل
riehle	رىهل
riel	رىل
riemens	رىمنز
riemers	رىمرس
rienks	رىىنكس
riepe	راىپ
ries	رىس
riffle	راىفل
rifkind	رىفكاىند
riggins	رىگىنز
rights	راىتز
rigler	رىگلر
rigo	رىگو
rihana	رىحانه
rijkaard	رىجكارد
rijswijk	رىسوىك
rimoni	رمونى
rindner	رىندنر
ring	رىنگ
ringuest	رىنگست
ringwood	رىنگوود
rinker	رىنكر
rinn	رىن
rinne	رىنه
rintoul	رىنتول
riordon	رىردان
rippel	رىپل
rischar	رىشار
risel	راىسل
rishah	رىشاه
risley	رىسلى
risto	رىستو
rita	رىتا
ritacco	رىتاكو
ritsgert	رىتىسگرت
rittweger	رىتوگر
rivard	راىوارد
river	رىور
rivers	رىورز
rivoire	رىوىره
rixon	رىكسون
riyad	رىدا
rizvi	رىزوى
roa	رو
roach	روچ
roar	رور
roath	روت
robb	راب
robbin	رابىن
robbins	روبىنز
robby	رابى
roberge	روبرج
roberta	روبرتا
roberto	روبرتو
robertson	ربرتسون
robey	رابى
robideaux	رابىدىاكس
robijn	رابىجن
robinson	رابىنسن
roboz	روبوز
roby	روبى
roch	راك
roche	روچ
rockel	راكل
rodberg	رادبرگ
roder	رادر
roderick	ردرىك
rodman	رادمن
rodrigue	رودرىگو
rodriguez	رودرىگز
roeber	روبر
roebuck	رىباك
roehrig	راهرىگ
roepcke	روىپك
roepke	روپكه
roesner	روازنر
roff	راف
rogalsky	روگالسكى
rogero	راگرو
rognerud	راگنرد
rogoza	روگوزا
rohan	روهان
rohbeck	راهبك
rohde	رود
rohm	روهم
rohn	روهن
rohrer	روهرر
roimata	روىماتا
rokicki	روكىكى
roldan	رولدان
rolfe	رولفه
rolff	رولف
romanchik	رمنچىك
romans	رمنس
romero	رومىو
romig	رومىگ
romulus	رامولوس
ronald	رونالد
ronda	روندا
rondane	روندىن
ronde	رونده
rongel	رانگل
rongo	رونگو
roni	رونى
ronit	رونىت
ronkin	رانكىن
ronnen	رانن
ronni	رانى
ronnie	رانى
rontgen	رانتگن
rony	رانى
rood	رود
roodenburg	رودنبرگ
rookery	روكرى
rooks	روكز
roosevelt	روزولت
root	روت
rootes	روتس
rooyen	روىن
ropebrake	راپبرىك
roper	راپر
rory	رورى
rosa	روسا
rosaire	روزىر
rosana	روسانا
roscoe	روسكو
roseberry	رزبرى
rosemarie	روزمارى
rosemary	روزمارى
rosen	روزن
rosenbaum	رزنباوم
rosenblatt	روسنبلات
rosencrans	رزنكرانس
rosenfeld	روسنفلد
rosenfelder	روزنفلدر
rosenjack	روزنجك
rosenlof	رزنلف
rosenman	رزنمن
rosham	روشام
rosie	روزى
rosita	روزىتا
roslyn	روسلىن
rosselin	روسلىن
rossen	رازن
rosser	روسر
rossiter	روسىتر
rossman	راسمن
rossner	روسنر
rosson	روسون
rossum	راسوم
rostad	روستاد
roston	راستن
rostrom	راسترام
rosu	روسو
rothe	روت
rothera	راترا
rotiala	روسىالا
rotz	روتز
rouch	راچ
rouen	روىن
roundel	روندل
rountree	رونترى
rourke	روركه
rouse	روز
roush	روش
rout	راوت
route	روت
rov	راو
rovner	راونر
rowbottom	راوباتم
rowett	روت
rowland	رولند
rowles	رولس
rowley	روىلى
roworth	راورت
rowsome	روسام
roxanne	روكسان
roxsan	روكسان
royal	روىال
royappa	روىاپا
royce	روىس
royle	روىل
royse	روىس
roytenberg	روىتنبرگ
roze	روز
rozier	روزىر
rubb	راب
rubie	روبى
rubin	رابىن
rubio	رابىو
rubottom	رابتم
ruckle	راكل
ruddy	رادى
rudewig	رادوىگ
rudloe	رودلو
rudnick	رادنىك
rudolphus	رودولفاس
rudramuni	رادرامونى
rue	رو
ruebel	روىبل
rueden	روىدن
ruehr	روهر
ruemmler	رىوملر
rueter	رواتر
ruey	رواى
ruholl	روهل
ruiz	رواىز
rukan	راكون
rumble	رامبل
rumples	رامپلز
rundle	راندل
runeson	رىونسون
runner	رانر
rupe	روپ
rushforth	راسفورد
rusk	راسك
ruspini	راسپىنى
russ	راس
russell	راسل
russo	راسو
rust	راست
rusty	راستى
rutabaga	روتاباگا
ruth	روت
rutherford	راترفورد
ruthstrom	راتستروم
rutks	راتكس
ruudt	رووت
rybolt	راىبلت
ryden	راىدن
ryder	رىدر
rydquist	رىدكوىست
rymon	رىمون
rysavy	رىساوى
rysling	رىسلىنگ
ryu	رىو
saartje	سارتج
sabine	سابىن
sabini	سابىنى
sabirah	صبىره
sabiston	سبىستن
sabourin	سابورىن
sabra	صبرا
sackett	سكت
sacks	ساكس
sackton	ساكتن
sadah	سده
saddique	سادىك
sadgrove	سدروو
sadira	صدىرا
safoutin	سافتىن
sage	سىگ
sahasi	ساهاسى
sahib	سهىب
sahr	سار
said	سعىد
saida	ساىدا
saidi	سعىدى
saint	سنت
sakamoto	ساكاموتو
sakari	ساكارى
sakaue	ساكاىو
saklad	ساكلاد
saklani	سكلانى
salanne	سالىن
saley	سىلى
salfi	سلفى
salgueiro	سالگورو
salma	سلما
salmi	سالمى
salmond	سالموند
salsman	سىلزمن
saltzman	سالتزمن
salwa	سلوا
salzberg	سالزبرگ
salzenberg	سالزنبرگ
sam	سم
samah	سما
samar	ثمر
samblanx	سمبلنكس
sambolec	سامبولىك
samec	سامك
sameer	سمىر
sameh	سامه
samel	سامل
samira	ثمىرا
samiyah	سمىاه
samma	سمما
samman	سامان
sammer	سامر
samosky	ساموسكى
sampath	سمپت
sample	سمپل
sams	سامز
samsel	سمسل
samuels	سامولس
sana	سانا
sancese	سانسس
sancheti	سانچتى
sand	ساند
sandberg	سندبرگ
sanders	سندرز
sanderson	ساندرسون
sandford	سندفورد
sandie	سندى
sandlin	سندلىن
sandman	سندمن
sands	سندس
sandvik	سندوىك
sane	سىن
sang	سانگ
sangal	سنگال
sangho	سانگو
sanjay	سانجاى
sannella	سانلا
sannertje	سنىرجه
sanov	سانو
sansburn	سانتسبرن
santa	سانتا
santanna	سانتانا
santee	سانتى
santiago	سنتىاگو
santje	سنجه
santo	سانتو
santos	سانتوس
santucci	سانتوسى
sanz	سانز
sarab	سراب
saranen	سارانن
sarathy	ساراتى
sardar	سردار
sardo	ساردو
sare	سىر
sarma	سارما
sarna	سارنا
sarrett	سارت
sarwate	سارواته
saslav	ساسلاو
sassenheim	ساسنهىم
sasze	سازه
satur	ساتور
sauer	ساوىر
saul	ساول
sauls	ساولز
saunders	ساندرز
sauriol	سارىول
sauter	ساوتر
sauther	ساوتر
savaram	ساوارام
savel	ساول
savela	سىولا
savetz	ساوتز
savin	ساوىن
savoy	ساووى
sawan	ساوان
sawchuk	ساوچوك
sawdey	ساودى
sawford	ساوفرد
sawyer	ساىوىر
saxe	ساكس
saxena	ساكسنا
saxnem	سكسنم
saxon	ساكسون
sayre	سىر
scally	اسكالى
scannell	سكانل
scarce	اسكارس
scearce	اسكىرس
schabus	شابوس
schafer	شافر
schagen	شاجن
scheepen	شىپن
scherwich	اسچرووىچ
schipluiden	اسكىپلوىدن
schmeer	شمىر
schmidt	اشمىت
schofield	شوفىلد
scholtz	شولتز
schon	شون
schoo	شو
schut	شات
schuyler	چوىلر
sciandra	سىاندرا
sco	اسكو
scollick	اسكالىك
scotia	اسكاتىا
scotoni	اسكوتونى
scotto	اسكاتو
scotty	اسكاتى
scowling	اسكولىنگ
scranton	اسكرنتن
screech	اسكرىچ
screve	اسكرىو
scribbling	اسكرىبلىنگ
scris	اسكرىس
scrub	اسكراب
scudds	اسكادز
scull	اسكال
scullin	اسكولىن
scully	اسكولى
sea	سى
seales	سىلز
seals	سىلز
sean	سىن
seanagh	سىنىگ
seanain	سىناىن
seanna	سىنا
searchnet	سىرچنت
searle	سىرل
seaver	سىور
seavy	سىوى
seawood	سىوود
sebastian	سباستىن
sebolt	سىبلت
sebree	سبرى
sebrianne	سبرىانى
security	سكىورىتى
sed	سد
seda	سدا
sedai	سداى
seder	سىدر
seds	سدس
sedvall	سدوال
see	سى
seebacher	سىباچر
seed	سىد
seedman	سىدمن
seelig	سىلىگ
seely	سىلى
seeney	سننى
seese	سىس
seewald	سىوالد
seewei	سىوى
segal	سگال
segura	سگورا
seh	سح
sehr	سهر
seibel	سىبل
seibl	سىبل
seil	سىل
seipel	سىپل
seitz	سىتز
seiyu	سىو
sekora	سىكارو
sela	سىلا
selberg	سلبرگ
selim	سلىم
selima	سلىما
selleck	سلك
selma	سلما
selwood	سىلوود
seman	سىمن
semele	سملى
semir	سمىر
semiz	سمىز
semotiuk	سموتىوك
sena	سنا
senftleben	سنفتلىبن
seng	سنگ
sengupta	سنگوپتا
senner	سىنر
sepehr	سپهر
sepinwall	سپىنوال
seppy	سپى
seputis	اسپوتىس
sequeira	سكوىرا
sercan	سركان
serchuk	سرچاك
serhir	سرهىر
serling	سرلىنگ
serpent	سرپنت
serratosa	سراتوزا
serre	سر
serres	سىرس
serrone	سىرون
servideo	سروىدىو
servis	سروىس
seshadri	سشادرى
seth	ست
sethurajan	ستهوراجان
sethuraman	ستورامان
seto	ستو
settle	ستل
seurer	سرر
seven	سون
severson	سورسون
sevier	سوىر
sewell	سول
sexton	سكستن
seytie	سىتى
shachat	شاچات
shadha	شداه
shadiyah	شدىه
shaker	شىكر
shakespeare	شكسپىر
shakya	شاكىا
shalette	شالىت
shaligram	شالىگرام
shallcross	شالكراس
shalom	شالوم
shamaliyah	شمىله
shamas	شاماس
shambat	شامبات
shambhu	شمبهو
shames	شىمز
shamim	شمىم
shamir	شامىر
shamis	شمىس
shammar	شمر
shan	شان
shanahan	شاناهان
shank	شانك
shankar	شانكار
shanker	شانكر
shannon	شانون
shanson	شانسون
shapero	شاپرو
shar	شار
shardlow	شاردلو
shari	شارى
shark	شرك
sharknas	شاركناس
sharks	شركس
sharlee	شارلى
sharock	شاروك
sharqiyah	شركىاه
shartzer	شارتزر
sharvari	شروارى
shaul	شاول
she	شى
shearer	شىرر
shebert	شبرت
shebs	شبس
sheckman	شكمان
sheehan	شىهان
sheehy	شىهى
sheep	شىپ
sheer	شىر
sheets	شىتز
shef	شف
sheffield	شفىلد
sheik	شىك
shein	شىن
sheipe	شپ
shekar	شكار
shel	شل
sheldon	شلدون
sheller	شلر
shelly	شلى
shelmidi	شلمىدى
shelton	شلتون
shen	شن
shenan	شنان
shenfeng	شنفنگ
sheng	شنگ
shenghun	شنقان
shenoy	شىنوى
shephard	شپرد
shepherd	شفرد
sheppard	شپارد
sher	شر
sherer	شرر
sheri	شرى
sherman	شرمان
sherriff	شرىف
sherry	شرى
sherwood	شروود
shetland	شتلند
shetler	شتلر
shetline	شتلاىن
sheyn	شىن
shi	شى
shiang	شىانگ
shidler	شىدلر
shimayah	شىماىه
shimin	شىمىن
shin	شىن
shipman	شىپمن
shirai	شىراى
shirley	شرلى
shiyekar	شىكار
shlaes	شلاىز
shockey	شاكى
shomer	شومر
shortell	شورتل
shorten	شورتن
shortreed	شرترىد
shoshani	ششانى
shostack	شاستك
shotton	شاتون
shoulder	شولدر
shoun	شون
shrestha	شرستا
shriver	شرىور
shryne	شراىنه
shtiegman	اشتىگمن
shub	شاب
shudes	شودز
shue	شو
shuen	شوان
shuff	شاف
shuh	شاه
shuholm	شاهولم
shukla	شاكلا
shulga	شالگا
shultz	شالتز
shum	شام
shumaker	شاماكر
shunnar	شاننار
shushen	شاشن
shuyler	شوىلر
siang	سىانگ
siano	سىانو
sibley	سىبلى
sicolo	سىكولو
sidler	سىدلر
sidor	سىدور
siebert	ساىبرت
siegel	سىگل
siejko	سىجكو
siembab	سىمباب
siemon	سىمن
siemonsen	سىمونسن
sierant	سىرانت
siering	سىرىنگ
sierra	سىرا
siew	سىو
siggs	سىگس
sigmon	سىگمن
sigmund	سىگموند
sihsobhon	سىهسوبهون
sijmen	سىجمن
sikes	ساىكس
sikora	سىكورا
silberman	سىلبرمن
silbermann	سىلبرمان
silk	سىلك
silva	سىلوا
silver	سىلور
silverberg	سىلوربرگ
silverman	سىلورمن
silverthorne	سىلورتورن
silverwood	سىلورود
silvey	سىلوى
silvia	سىلوىا
silvio	سىلوىو
silvonen	سىلونن
simard	سىمارد
simcik	سىمسىك
simen	سىمن
simer	سىمر
simicich	سمسچ
simin	سىمىن
siming	سىمىنگ
simko	ساىمكو
simmer	سىمر
simmonds	سىمندس
simmons	سىمونس
simms	سىمس
simodynes	سىمودىنز
simon	سىمون
simona	سىمونا
simonds	سىموندس
simone	سىمونه
simons	سىمونز
simplicity	سىمپلىسىتى
sims	سىمس
sin	سىن
sinan	سىنان
sinclair	سىنكلارى
sindelman	سىندلمن
sindre	سىندره
sing	سىنگ
sinibaldi	سىنىبالدى
sipe	ساىپ
sipples	سىپلز
sipriano	سىپرىانو
siqi	سىكى
sir	سر
sircombe	سركامب
sires	سىرس
sirois	سىروىز
sisk	سىسك
sislo	سىسلو
sit	سىت
sita	سىتا
sitaram	سىتارام
sites	ساىتز
sitrah	سىتراه
sittler	سىتلر
siuuirdingelant	سىىواىردىنگلنت
skahan	اسكاهان
skari	اسكارى
skartsis	اسكارتسىس
skaven	اسكاون
skaya	اسكاىا
skean	اسكىن
skee	اسكى
skeeter	اسكىتر
skelton	اسكلتن
skep	اسكپ
skerries	اسكراىز
skerry	اسكرى
skiba	اسكىبا
skiles	اسكىلس
skinner	اسكىنر
skip	اسكىپ
skippy	اسكىپى
sklower	اسكلوىر
sky	اسكاى
slabotnen	اسلبوتنن
slan	اسلان
slaney	اسلىنى
slangsvold	اسلنگزوالد
slankard	اسلانكارد
slash	اسلش
slashing	اسلشىنگ
slate	اسلىتى
slatkin	اسلاتكىن
slattery	اسلاترى
slave	اسلىو
slavenburg	اسلاونبرگ
slavin	اسلاوىن
slawek	اسلاوك
slawomir	اسلاومىز
sledd	اسلد
sledge	سلج
sleep	اسلىپ
sleeper	اسلىپر
sletten	اسلتن
slim	سلىم
slimane	اسلىمان
slippery	سلىپرى
sliupas	اسلىوپاس
sloan	اسلون
sloane	سلون
sloman	اسلومن
slone	اسلان
slope	اسلوپ
slothouber	اسلاتوبر
slotkin	اسلاتكىن
sluka	اسلوكا
slumkey	سلامكى
slut	سلات
sly	سلاى
smadja	اسمادج
smakovane	سمكوون
small	اسمال
smalley	اسمالى
smart	اسمارت
smead	اسمىد
smeall	اسمىل
smedley	اسمدلى
smeds	اسدس
smirnov	اسمىرنو
smiths	اسمىتز
smithson	اسمىتسون
smithwick	اسمىتوىك
smitley	سمىتلى
smits	اسمىتز
smoky	اسموكى
smolen	اسملن
smolik	اسمولىك
smoot	اسموت
smyley	اسمىلى
smythe	اسماىت
snail	اسنىل
sneed	اسنىد
snehal	سنهال
sneissel	اسنىسل
snel	اسنل
snelling	اسنلىنگ
snorri	سنورى
snotoa	سنوتو
snow	اسنو
snowden	اسنودن
snowfield	اسنوفىلد
snug	اسناگ
snyder	اسناىدر
sobhan	سبحان
sobotka	سوبوتكا
soderblom	سادربلام
soft	سافت
software	سافتور
sogen	سوگن
soha	سوها
sohm	سوهم
sohrab	سهراب
sokol	سوكول
sol	سول
solar	سولار
solberg	سلبرگ
sold	سولد
solek	سولك
soli	سولى
solis	سولىس
solo	سولو
solodov	سلودوف
solomon	سولومون
solovier	سولوىر
solvay	سولوى
soma	سوما
somashekar	سوماشىكار
someren	سمرن
somerville	سومروىل
somesh	سامش
something	سامتىنگ
somjee	سومجى
son	سان
songer	سونگر
songerwala	سونگروالا
songkran	سونگكرن
sonja	سونجا
sonny	سونى
sony	سونى
soo	سو
sopan	سوپن
sor	سور
sorab	سوراب
sorabh	سوراب
sorc	سورك
sore	سور
soren	سورن
sorensen	سورنسن
sorin	سورىن
sorrel	سورل
sotilas	سولىتاس
soto	سوتو
sou	سو
soucek	سوكك
soudan	سودان
soumen	سومن
soun	سون
source	سورس
sousa	سوسه
sowder	سودر
soyack	سوىاك
sozo	سوزو
spaarndam	سپارندام
spacek	اسپىسىك
spangler	اسپانگلر
sparks	اسپاركس
sparrow	اسپارو
spatafora	اسپاتافورا
spatz	اسپاتز
spaulding	اسپاولدىنگ
spear	اسپىر
spearing	اسپىرىنگ
spears	اسپىرز
speden	اسپىدن
speer	اسپىر
spelman	اسپلمن
spence	اسپنس
spero	اسپىرو
sperry	اسپرى
sphar	اسفار
spider	اسپاىدر
spiders	اسپاىدرز
spiers	اسپىرز
spies	اسپاىز
spike	اسپاىك
spikes	اسپاىكس
spinak	اسپىناك
spindrift	اسپىندرىفت
spine	اسپىن
spinning	اسپاىنىنگ
spires	اسپاىرز
spiro	اسپىرو
spiros	اسپىراس
spisak	اسپىساك
spit	اسپىت
spivak	اسپىواك
spleid	اسپلىد
splinter	اسپلىنتر
spolarich	اسپولارىخ
sporay	اسپورى
spotswood	اسپاتسوود
spousta	اسپوستا
sprag	اسپراگ
sprayberry	اسپرىبرى
sproat	اسپروت
spur	اسپر
squire	اسكواىر
squirrel	اسكواىرل
stabell	استىبل
stacey	استىسى
stachnik	استچنىك
stacy	استىسى
stadler	استدلر
stafford	استافورد
stagg	استاگ
staggers	استىگرس
stailey	استىلى
staines	استىنز
stainless	استاىنلس
stajano	استاجانو
stam	استام
stamper	استامپر
stan	استن
stancomb	استنكامب
stanford	استنفرد
stangier	استانگىر
stansell	استنسل
staples	استىپلز
star	استار
starbuck	استارباك
starcap	استاركىپ
stark	استارك
starkey	استاركى
starr	استار
stars	استارز
start	استارت
startled	استارتلد
startz	استارتز
stas	استاس
statham	استاتم
stealer	استىلر
stearn	استىرن
stearns	استىرنز
stec	استك
stedina	استدىنا
stedman	استدمن
steel	استىل
steele	استىل
steen	استىن
steep	استىپ
stefano	استفانو
stegen	استگن
stelly	استلى
stenberg	استىنبرگ
stenfort	استنفورت
stensrud	استنسراد
stephane	استفان
stephanus	استفانز
stephenson	استفنسون
stepke	استپك
stepken	استپكن
steriti	استرىتى
sterne	استرن
steven	استىون
stevenson	استونسن
steves	استىوز
stew	استو
stewart	استوارت
stian	استىن
stiansen	استىانسن
stickelman	استىكلمن
stieber	استىبر
stig	استىگ
stigberg	استىگبرگ
stiles	استىلز
still	استىل
stineman	استاىنمن
stinson	استىنسون
stirling	استرلىنگ
stith	استىت
stobert	استابرت
stock	استوك
stockman	استاكمن
stocks	استاكس
stockslager	استاكسلاجر
stodola	استودولا
stoffel	استافل
stok	استوك
stoker	استاكر
stoklas	استوكلاس
stolcke	استالكه
stoler	استلر
stoller	استولر
stolte	اسولت
stookey	استوكى
storer	استورر
storey	استورى
storga	استورگا
storleer	استورلىر
storms	استورمز
story	استورى
stothers	استاترز
stoun	استون
stowbridge	استوبرىج
stowell	استول
stoy	استوى
strader	استرادر
strand	استرند
strasheim	استراشىم
straton	ستراتون
straub	استراوب
strawbridge	استرابرىج
strayer	استرىر
stream	استرىم
streater	سترىتر
stremler	استرملر
strider	استرىدر
striebel	استرىبل
stringer	استرىنجر
strini	استرىنى
strock	استروك
strouss	استروس
stroustrup	استروستراپ
stroyan	استرىان
struckman	استراكمن
strum	استروم
strydom	استرىدم
stubbs	استابز
stuckey	استاكى
stucki	استاكى
stude	استاد
student	استىودنت
stuplich	استاپلىچ
sturges	استارگس
sturgill	استارگىل
sturim	استورىم
sturluson	ستارلوزن
stutzman	استاتزمن
styles	استاىلز
subhani	سابهانى
subhendu	سوبهاندو
sublette	سابلت
subramaniam	سابرامانىام
subramanian	سابرامانىان
subtense	سابتنس
suchan	سوچان
sucia	سوشىا
sudan	سودان
sudarmo	سودارمو
sudarshan	سودارشان
sudip	سودىپ
sudipto	سودىپتو
sudupe	سادىوپ
sue	سو
suffer	سوفر
suga	ساگا
sugai	ساگاىى
sugars	ساگارس
suha	سوها
suhas	سوهاس
sukumar	سوكومار
sulaymaniyah	سولاىمنىاه
sullivan	سالىوان
sully	سالى
sulphur	سولفور
sultan	سولتان
sumanth	سامانتا
sumgin	سامگىن
sumit	سامىت
summers	سامرز
summit	سامىت
sumon	سامون
sumrall	سامرال
suna	سونا
sunando	ساناندو
sundaram	ساندرم
sunday	ساندى
sundeep	ساندىپ
sundelin	ساندلىن
sune	سىون
suneet	سانىت
sung	سانگ
sungold	سانگلد
sunil	سانىل
sunken	سانكن
sunker	سانكر
sunley	سانلى
sunni	سانى
sunny	سانى
sunondo	سانوندو
sunrise	سانراىز
sunrong	سانرانگ
sunset	سانست
sup	ساپ
supratic	سوپراتىك
supriyo	سوپرىو
suraj	سوراج
surana	سورانا
surinder	سورىندر
survey	سروى
susa	سوسا
susalis	سوزالىس
susanne	سوزانه
sushil	سوشىل
suska	ساسكا
sussman	ساسمن
sustik	ساستىك
suter	سوتر
sutkus	ساتكاس
sutphen	سوتفن
sutter	سوتر
suture	ساچر
suwayda	سوىده
suwito	سوىتو
suze	سوز
suzy	سوزى
swa	سوا
swafford	سوافورد
swag	سوگ
swagato	سواگاتو
swami	سوامى
swamy	سوامى
swan	سوان
swank	سوانك
swany	اسواناى
swart	سوارت
swash	سواش
swearingin	سوارىنگىن
swearman	سوارمن
swensen	سونسن
swift	سوىفت
swine	سوىن
swingler	سوىنگلر
swink	سوىىنك
swinnerton	سوىنرتون
swisher	اسوىشر
switenky	سوىتنكى
sydney	سىدنى
sylvia	سىلوىا
syme	ساىم
symington	سىمىنگتون
sync	سىنك
systems	سىستمز
sytje	سىتجى
taatje	تاته
table	تىبل
tabuk	تبوك
tad	تاد
taffone	تافون
tafilah	تعفىله
tagle	تگل
tahara	تاهارا
tahirah	تهىراه
tahoun	تاهون
tahsin	تحسىن
tai	تاى
taka	تاكا
taki	تاكى
takiyah	تكىاه
talbert	تلبرت
talboys	تالبوىز
talcott	تالكوت
talib	تلىب
talibah	تلىباه
tallan	تالان
tallent	تلنت
talman	تالمن
talmy	تالمى
tam	تام
tamai	تاماى
tamas	تاماس
tamburri	تمبرى
tame	تىم
tamir	تمىر
tampas	تامپاس
tanak	تاناك
tandiary	تندىرى
tanis	تانىس
tanneken	تنىكن
tanton	تانتون
tants	تنتس
tanwar	تنور
tapio	تاپىو
tappin	تاپىن
taraz	تراز
tardell	تاردل
tariq	طرىق
tarr	تار
tarub	طروب
tasdeler	تاسدىلر
tasker	تسكر
tat	تات
tatby	تاتباى
tate	تىت
taterway	تاتروى
tatsuro	تاتسورو
tattam	تاتام
tavares	تاوارس
tavernini	تاورنىنى
tay	تى
teague	تىگو
teche	تك
teck	تك
teed	تىد
teeling	تىلىنگ
teeth	تىت
tegelberg	تگلبرگ
teh	ته
tehan	تىهان
telecom	تلكوم
tell	تل
teller	تلر
tello	تللو
tempelman	تمپلمن
tempest	تمپست
templar	تمپلر
templeton	تمپلتون
tenaya	تناىا
tenbrook	تنبروك
tennebo	تنبو
tennyson	تنىسان
tenorio	تنورىو
tenpo	تنپو
tent	تنت
teppo	تپو
teresa	ترسا
teri	ترى
terminal	ترمىنال
ternes	ترنس
ternyck	ترنىك
terrace	تراسه
terrada	ترادا
terran	تران
terrapin	تراپىن
terrell	ترل
terrence	ترنسه
terri	ترى
terris	ترىس
territory	ترىتورى
terror	ترور
terry	ترى
tertene	ترتنه
teruel	ترول
teruhiko	تروهىكو
terwilliger	تروىلىگر
teshima	تشىما
tesla	تسلا
tesler	تسلر
tess	تس
tessner	تسنر
testa	تستا
tester	تستر
tetervin	تتروىن
tether	تتر
tetrad	تتراد
teunis	تىونىس
teusink	توسىنك
tewari	توارى
tewie	توىه
tex	تكس
thabit	تبت
thalberg	تالبرگ
thallmayer	تالماىر
thana	تانا
thapa	تاپا
thara	دارا
thayer	تاىر
thedell	تدل
theis	تىز
thelander	تلاندر
thelen	تىلن
therese	ترزه
theroux	تىروكس
thief	تىف
thilo	تاىلو
tho	تو
thom	تام
thomas	توماس
thommesen	تامسن
thomsen	تامسون
thong	تونگ
thoresen	تورىسن
thornley	تورنلى
thornton	تورنتون
thorpe	تورپ
thorson	تارسون
thorud	توراد
thorup	توروپ
threston	ترستون
throop	تروپ
thulen	تىىولن
thumb	تامب
thurayya	توراىا
thurber	توربر
thurlede	ترلدى
thurlo	ترلو
thurman	تورمن
thurn	تارن
tichauer	تىچاور
tiebout	تىبوت
tien	تىن
tierie	ترى
tierney	تىرنى
tifford	تىفورد
tiits	تىتس
tijmen	تاىجمن
tilbury	نىلبرى
tilden	تىلدن
tilgner	تىلگنر
tillotson	تىلوتسان
timbol	تىمبول
timian	تىمىان
timko	تىمكو
timmins	تىمىنز
timonin	تىمونىن
timur	تىمور
tin	تىن
tina	تىنا
ting	تىنگ
tingley	تىنگلى
tinney	تنى
tinsel	تىنسل
tinsley	تىنسلى
tiny	تىنى
tio	تىو
tioga	تىوگا
tippu	تىپو
tirza	تىرزا
tisza	تىسزا
title	تاتل
titmus	تىتماس
tjaatje	جاتجى
toal	تول
tobe	توب
tobias	توبىاس
tobin	توبىن
tofferi	توفرى
toft	تافت
toida	توىدا
toit	توىت
tokman	تاكمن
tokyo	توكىو
tolani	تولانى
toledo	تولدو
toleno	تالنو
tolman	تولمن
tolvanen	تالوانن
tom	توم
tomany	تومانى
tomatius	توماتىوس
tombros	تامبروس
tomes	تومز
tomi	تامى
tomines	تامىنز
tompkins	تامپكىنز
toms	تامز
tomura	تامارا
tonar	تونار
toner	تونر
tong	تانگ
tongue	تانگ
tonjes	تونجس
tony	تونى
tooley	تولى
toon	تون
tooth	توس
topic	تاپىك
toptani	تاپتانى
torda	توردا
toren	تورن
torigoe	ترىجو
tormala	تورمالا
torres	تارس
torrez	تورز
torrie	تورى
toscano	توسكانو
totty	توتى
touch	تاچ
tow	تاو
tower	تاور
tra	ترا
tracy	تراىسى
trafford	ترفورد
trafton	ترافتون
traiectensis	تراىستنىس
trainham	ترىنهام
trainor	ترىنور
trapp	تراپ
trash	ترش
traster	تراستر
travaglia	تراواجلىا
traynor	تراىنور
treadway	ترىدوى
treindl	ترىند
treitel	ترىتل
trent	ترنت
trethowan	ترتوان
treuerice	رورىس
trevor	ترىور
trickett	ترىكت
triemstra	ترىمستار
triggs	ترىگس
trim	ترىم
trindade	ترىنداد
trinkle	ترىنكل
triolo	ترىولو
tripps	ترىپس
tristram	ترىسترم
troedson	ترودسون
trollinger	ترولىنگر
trometer	ترومىتر
tron	ترون
trotter	تروتر
trough	تروف
troughton	تروگتون
trout	تروت
trown	تراون
trucco	تراكو
trudel	ترودل
true	ترو
truesdale	تروىسدىل
truex	تروكس
truitje	ترتجى
trull	ترول
trumbo	ترومبو
tryntje	تراىنته
tubutis	توبوتىس
tucker	تاكر
tudor	تادر
tufte	توفته
tufts	تافتز
tuglu	تاگلو
tula	تولا
tuli	تولى
tulio	تولىو
tully	تولاى
tulse	تالس
tuna	تىونا
tunen	تانن
tung	تونگ
tunga	تونگا
tuohela	توهلا
tuomas	توماس
tuomi	تومى
tuong	تونگ
tupper	تاپر
tupshin	تاپشىن
turambar	تورامبر
turco	توركو
turcotte	توركات
turin	تورىن
turkel	تاركل
turmelle	تارمل
turner	تورنر
turnitsa	ترانىتسا
turoff	توروف
turtle	تورتل
turton	ترتون
tushar	توشار
tusing	توسىنگ
tuso	توسو
tuthill	تاتىل
tuxbury	تاكسبرى
tuyet	توىت
tweedale	توىىدىل
tweedie	توىدى
twigg	توىىگ
twin	توىن
twiss	تووىس
twitchell	تواىچل
two	تو
tye	تاى
tyler	تىلر
tymen	تاىمن
tymes	تىمز
tyndall	تىندال
tyng	تىنگ
tynor	تاىنور
tyrone	تاىرون
tysinger	تىسىنجر
tyson	تاىسن
tytie	تىتى
ubaid	اوبىد
ubiera	ىوبىرا
udo	اودو
udolph	ادولف
uemura	ىومورا
uenal	ىونال
uffington	اوفىنگتون
ugur	اوگار
ukelo	ىوكىلو
ukraine	اوكراىن
ulima	علىما
ullman	اولمن
ulvestad	اولوستاد
umar	عمر
umberger	اومبرگر
umlas	اوملاس
unaiza	عنىزه
unpingco	انپىنگكو
unruh	انراه
unsicker	انسىكر
upchurch	اپچرچ
uplands	اپلندس
upright	اپراىت
upston	اپستن
uranium	ىورانىم
urena	ىورىنا
uri	اورى
urma	اورما
user	ىوزر
vaccaro	وكرو
vadaparty	واداپارتى
vadlamudi	ودلمودى
vaggen	واگن
vagner	واگنر
vaitkus	وىتكوس
vajdic	واجدىك
valance	والانس
valdez	والدز
vale	وال
valentijn	ولنتىن
valerian	والرىن
valihora	والىهور
valkenaar	والكنار
valley	والى
valur	والور
van	فون
vanantwerp	وانانتورپ
vanburen	ونبورن
vance	وانسى
vancko	ونكو
vancuren	ونكورن
vandeman	وندمن
vandenburgh	واندنبرق
vanderford	وندرفورد
vanderveer	وندروىر
vandousen	وندوسن
vandry	وندرى
vanduzen	وندازن
vandyck	وندىك
vanecek	وانسك
vang	ونگ
vanick	ونىك
vankeuren	ونكورن
vanriper	ونرىپر
vanschoonhoven	وانسكونهون
vanvleck	ونلك
vanvranken	ونورانكن
vanzandt	ونزنت
vardan	وردان
vardi	واردى
vargo	وارگو
variants	وارىانتز
varieur	وارىور
varlow	ورلو
varma	وارما
varnes	وارنس
varney	وارنى
varty	وارتى
varvel	وارول
vato	واتو
vawdry	واودراى
vaya	واىا
veasey	وىسى
vecoven	وىكاون
ved	ود
vee	وى
vela	ولا
velasco	وىلاسكو
velden	ولدن
veldman	ولدمن
vella	ولا
velletri	ولترى
veloso	ولوسو
ven	ون
venable	وىنىبل
venables	ونابلس
venkat	ونكات
venner	ونر
ventureli	ونترلى
verbeck	وربك
verhulst	ورهوست
verity	ورىتى
verlinde	ورلىند
verma	ورما
vermaas	ورماس
vermaseren	ورماسرن
vermeulen	ورمولن
vermillion	ورمىلىىون
vernon	ورنن
verweij	وروىج
vessels	وسلز
vessey	وسى
vest	وست
vestal	وستال
vestli	وستلى
vezina	وزىنا
vianen	وىانن
vic	وىك
vicious	وىسىوس
vickers	وىكرس
victim	وىكتىم
victor	وىكتور
vidal	وىدال
video	وىدىو
vieux	وىوكس
vigen	وىگن
vik	وىك
vikas	وىكاس
vikram	وىكرام
viktor	وىكتور
vila	وىلا
viladot	وىلادوت
vilas	وىلاس
viles	وىلز
viljo	وىلجو
villa	وىلا
villani	وىلىانى
villard	وىلارد
vimal	وىمال
vin	وىن
vinata	وىناتا
vincent	وىنسنت
vineis	وىنىز
vinko	وىنكو
vinson	وىنسون
viola	وىولا
vipin	وىپىن
viraf	وىراف
viren	وىرن
virendra	وىرندرا
virgil	وىرجىل
virtanen	وىرتانن
virtual	وىرچوال
visca	وىسكا
vish	وىش
vision	وىژون
visionary	وىژنرى
vispi	وىسپى
visser	وىسر
vitaca	وىتاكا
vito	وىتو
vitor	وىتور
vitt	وىت
vittoria	وىتورىا
viva	وىوا
vivek	وىوك
vivian	وىوىان
viviane	وىوىانه
vizen	وىزن
vladan	ولادان
vlado	ولادو
voccia	وككىا
vogel	ووگل
vogl	وگل
vogler	ووگلر
vohra	وهرا
vojak	ووجاك
voldman	ولدمن
volkman	ولكمان
vollum	والوم
volodin	ولودىن
voltmer	ولتمر
volz	ولز
von	ون
vonk	وانك
vos	وس
voss	ووس
vowles	وولز
vrouwtje	رووت
vulis	ولىس
wack	وك
wackerfuss	وكرفاس
wade	واده
wafa	وافا
wafiyyah	وافىاه
wagle	واگل
wah	واه
wai	وى
wail	وىل
waingrow	واىنگرو
wainstead	وىنستد
waite	وىت
waites	وىتز
wajihah	وجىحه
wake	وىك
wal	وال
waldmanneuenna	والدمنىونا
waldo	والدو
waldram	والدرام
walenta	ولنتا
wales	والز
walidah	ولىده
walka	والكا
walkerdine	واكرداىن
walle	واله
wallewein	والوىن
wallin	والىن
wallington	والىنگتن
wallis	والىس
wallman	والمن
wally	والى
walter	والتر
walters	والترز
waltman	والتمن
walton	والتن
walworth	والورت
wan	ون
wand	وند
warborough	واربورو
warburton	واربرتون
ware	وىر
warn	وارن
warner	وارنر
wasay	وسى
waseem	واسم
washington	واشنگتون
wasik	واسىك
wasit	وسىط
waskey	واسكى
waslo	واسلو
wass	واس
watanabe	واتانىب
waterhouse	واترهاوس
waterman	واترمن
waters	واترز
watkins	واتكىنز
watt	وات
watterson	واترسون
watts	واتس
wavle	والو
weage	وىگ
weare	وىر
weast	وىست
weaston	وىستون
weaver	وىور
webb	وب
weber	وبر
webster	وبستر
wechner	وچنر
wedelin	ودلىن
wedemeier	ودمىر
wee	وى
weedon	وىدون
weeks	وىكس
weers	وىرز
wegert	وىگرت
wegner	وگنر
weidman	وىدمان
weigend	وىجند
weikamp	وىكامپ
weiland	وىلند
weiler	وىلر
weimann	وىمان
weimar	وىمر
wein	وىن
weinberg	وىنبرگ
weinelt	وىنلت
weinert	وىنرت
weinstock	وىنستوك
weintz	ونتز
welam	ولام
wellemtje	ولمتج
wellingk	ولىنك
wellington	ولىنگتون
wellman	ولمن
wells	ولز
welter	ولتر
welty	ولتى
welzel	ولزل
wen	ون
wench	ونچ
wendel	وندل
wendell	وندل
wendland	وندلند
wendzel	وندزل
wensel	ونسل
wermont	ورمونت
wernegreen	ورنگرىن
werner	وارنر
werry	ورى
wershoven	ورشوون
wesley	وسلى
wesleyan	وسلىان
wesson	وىسون
weste	وست
wester	وستر
westerholm	وسترهلم
western	وسترن
westerveldt	وسترولدت
westfall	وستفال
westley	وستلى
westmoreland	وستمورلند
weston	وستن
westphal	وىستفال
wet	وت
wetmore	وتمور
whadzen	وادزن
whalen	والن
whaley	والى
whalley	والى
wharton	وارتون
wheat	وىت
wheeler	وىلىر
whelan	ولان
whinen	وىنن
whitaker	واىتىكر
whitcomb	وىتكامب
whiteaker	واىتىكر
whitehorn	واىتهرن
whitehouse	واىتهوس
whitfield	وىتفىلد
whitson	وىتسون
whittaker	وىتاكر
whittemore	وىتمور
whittenburg	وىتنبرگ
whittington	وىتىنگتون
whitwell	وىتول
whitworth	واىتورس
whorwood	وروود
wibowo	وىبووو
wick	وىك
wickham	وىكهام
wicks	وىكس
widad	وىداد
widdul	وىدال
wide	واىد
widere	وىدىر
widmer	وىدمر
wiebe	وىت
wieland	وىلند
wiepkje	واىپكج
wier	وىر
wierse	وىىرس
wiersma	وىرسما
wietse	وىتسه
wiewer	وىوور
wifall	وىفال
wiggin	وىگجىن
wigle	واىگل
wigley	وىگلى
wigmore	وىگمور
wigston	وىگستون
wigton	وىگتون
wijbrand	وىجبرند
wijdan	وىجن
wijnand	وىجنند
wiklund	وىكلوند
wilcox	وىلكاس
wildcat	وىلدكات
wilder	واىلدر
wilderman	وىلدرمن
wildfong	وىدفانگ
wilding	وىلدىنگ
wiles	وىلس
wiley	وىلى
wilford	وىلفرد
wilhelm	وىلهلم
wilhelmus	وىلهلموس
wilhite	وىلهاىت
wilken	وىلكن
wilkens	وىلكنس
wilkerson	وىلكرسون
wilkin	وىلكىن
wilkins	وىلكىنز
wilkinson	وىلكىنسون
willard	وىلارد
willats	وىلاتز
willemintje	وىلمىنته
willey	وىلى
william	وىلىام
williamina	وىلىامىنا
willing	وىلىنگز
willingham	وىلىنگهام
willmore	وىلمور
willner	وىلنر
willour	ولر
wills	وىلز
willson	وىلسون
willy	وىلى
wilmer	وىلمر
wilmot	وىلموت
wimberley	وىمبرلى
wimpje	وىمپجى
wincn	وىنسن
wind	وىند
winders	وىندرز
windom	وىندوم
winiecki	وىنىكى
wininger	وىنىنگر
winkelmann	وىنكلمان
winkels	وىنكلز
winkle	وىنكل
winokur	وىنوكر
winsor	وىنسر
winston	وىنستون
winstrom	وىنستروم
winter	وىنتر
winterer	وىنترر
winterfeld	وىنترفىلد
wintermute	وىنترمىوت
winters	وىنترز
winz	وىنز
wirt	وىرت
wiryana	وىرىانا
wisal	وىسال
wise	واىز
wiseman	واىسمن
wiser	وىسر
wiserner	وىزرنر
witchard	وىچارد
wittick	وىتىك
wolfson	ولفسون
wolke	ولك
wolman	وولمن
wolski	ولسكى
woltering	وولترنىنگ
wombwell	وامبول
won	ون
wood	وود
woodburn	وودبرن
wooded	وودد
wooden	وودن
woodgate	وودگىت
woodhouse	وودهاوس
woodrow	وودرو
woodward	وودوارد
woog	ووگ
wook	ووك
woollard	وولارد
woolley	وولى
woon	وون
worchick	ورچىك
worden	ووردن
workman	وركمن
worling	ورلىنگ
worrilow	ورىلو
wouter	ووتر
wright	راىت
wrobel	وروبل
wun	وون
wust	واست
wyman	وىمن
wyntje	وىنتجى
xaros	زاروس
yacob	ىاكوب
yager	ىاگر
yahsi	ىاسى
yake	ىىك
yakootah	ىاكوتا
yamaha	ىاماها
yamha	ىمها
yaminah	ىامىناه
yan	ىان
yang	ىانگ
yangi	ىانگى
yanowitz	ىانووىتز
yanson	ىانسون
yanzek	ىانزك
yap	ىاپ
yarman	ىارمان
yaron	ىارون
yaros	ىاروس
yaryan	ىارىان
yasar	ىسرا
yasirah	ىاسىراه
yates	ىىتز
yaw	ىاو
yazid	ىزىد
yearwood	اىروود
yeats	ىىتز
yeka	ىىكا
yelich	ىلىچ
yelland	ىلند
yerger	ىارگر
yermish	ىرمىش
yermo	ىورمو
yetter	ىتر
yok	ىوك
yonas	ىوناس
yongsup	ىونگساپ
york	ىورك
yosef	ىوزف
yoshio	ىوشىو
yossi	ىوسى
yossy	ىوسى
youlin	ىولىن
youmans	ىومانس
younger	ىانگر
youse	ىوس
yousten	ىوستن
yumn	ىمن
zabel	زابل
zachary	زاچارى
zafina	زفىنا
zagar	زاگار
zahid	ظهىد
zahirah	زهرا
zainab	زىنب
zaira	زىرا
zaki	زكى
zalan	زالان
zammit	زامىت
zamore	زامور
zang	زنگ
zangerl	زانگرل
zanneke	زانكه
zapara	زاپارا
zara	زهرا
zaria	زارىا
zaynah	زىنه
zaza	زازا
zec	زك
zeke	زك
zella	زلا
zeller	زلر
zeman	زمان
zemanek	زمانك
zen	زن
zepka	زپكا
zeyer	زىر
zimraan	زمىران
zinser	زىنسر
zirilli	زىرىلى
zito	زىتو
zjarritjen	ژارىتژن
zocca	زوكا
zoeterwoude	زاتروود
zolmer	زولمر
zontek	زونتك
zuleika	زلىكاه
zurink	زورىنك
zuvieta	زووىتا
zygmunt	زىگمونت
zyl	زىل
