hetfield	היטפילד
smalley	סמולי
cavalieri	קאבאליירי
bachchan	באצ'אן
viggo	ויגו
szoke	סזוק
bernie	ברני
pulci	פולשי
joseph	ג'וזף
cornwell	קורנויל
muller	מולר
ethiopian	אתיופיאן
talebloo	טאלבלו
madsen	מאדסן
dutton	דאטן
antarctica	אנטארקטיקא
lynn	לין
ferydoon	פריידון
halonen	האלונין
cannes	קאן
cindy	סינדי
gaetano	גאיטאנו
geddes	גידיס
ventimiglia	וינטמיליא
bellini	ביליני
hasekura	האסיקורא
natale	נאטאלי
kumar	קומאר
fredrik	פרידריק
siddig	סידיג
kumai	קומאי
kitts	קיטס
berto	בירטו
colorado	קולוראדו
arturo	ארטורו
herbin	הרבן
seki	סקי
grisham	גרישאם
giovanna	ג'ובאנא
blunt	בלאנט
tokimune	טוקימונה
minobe	מיינוב
cantor	קאנטור
matthias	מאטיאס
larsson	לארסון
randall	ראנדאל
peary	פירי
barazite	באראזאיט
parmenides	פארמנידס
poseidon	פוסידון
satu	סאטו
gamarra	גאמארא
bergman	ברגמאן
ryutaro	ריוטארו
chenene	צ'נן
shevchenko	שבצ'נקו
sanetomi	סאנטומי
zaghloul	זגלול
pedros	פידרוס
hara	הארא
uzbekistan	אוזבקיסטאן
arief	עריף
nara	נארא
laigle	לייגל
oumar	עומר
ariel	אריאל
nisanit	ניסנית
connie	קוני
kuranyi	קוראני
bakri	בקרי
nicolas	ניקולאס
fellini	פיליני
milito	מיליטו
brede	ברידי
maastricht	מאסטריכט
miloud	מילוד
eelam	אילאם
michael	מאיקל
kalashnikov	קלאשניקוב
mpumalanga	מפומאלאנגא
rubio	רוביו
latina	לאטינא
kedumim	קדומים
law	לו
bridges	ברידג'ז
shamsul	שמסול
asad	אסד
nissim	נסים
putin	פוטין
dionysus	דיוניסוס
ovadia	עובדיה
pallister	פאליסטר
keitel	קאיטל
tikopia	טיקופיא
ifil	איפיל
grier	גריר
friedmann	פרידמאן
norfolk	נורפולק
dotchev	דוצ'ב
ľubomir	לובומיר
lafuente	לאפוינטי
staudinger	שטאודינגר
simeon	סימיאן
mexico	מקסיקו
najah	נג'אח
huygens	הוגינס
dagher	דאגר
burgess	בורגיס
bartlett	בארטלט
ardabil	ארדביל
anatoly	אנאטולי
terasoma	טיראסומא
adolf	אדולף
magda	מאגדה
donatello	דונאטילו
masaryk	מאזאריק
saari	סערי
faulk	פולק
morales	מוראליס
chamran	צ'מראן
bernadotte	ברנאדוט
schacht	שאכט
swaile	סוייל
swank	סואנק
ronen	רונן
matteo	מאטאו
cassin	קאסין
doom	דום
canizares	קאניזאריס
zetlitz	זיטליץ
staunton	סטונטון
yvonne	ייבון
australopithecus	אוסטראלופיתקס
kobushi	קובושי
roshan	רושאן
riccardo	ריקארדו
walcott	ואלקוט
ascoli	אסקולי
ayan	עיאן
hipolito	היפוליטו
heynckes	הינקס
gaetan	גאיטאן
romarin	רומארין
pattinson	פאטינסון
kuyt	קויט
smetana	סמיטנא
gabriela	גאבריאלה
feodor	פיודור
server	סירבר
curl	קורל
ajami	ע'גמי
northam	נורתאם
mubarek	מובארק
messali	מסאלי
sperone	ספירוני
madison	מאדיסן
weikart	וייקארט
gaziantep	גאזיאנטפ
pollock	פולוק
carolina	קארולאינא
buzek	בוזק
sudoku	סודוקו
wisconsin	ויסקונסן
tenorio	טינוריו
tanzania	טנזאניא
macho	מאצ'ו
marcomanni	מארקומאני
spiegler	ספיגלר
wiseman	ואיזמאן
berner	בירנר
ceni	סני
kovalyov	קובאליוב
nehoda	ניהודא
nyilasi	נילאסי
hochu	הוצ'ו
melhem	מלחם
ruhl	רול
vaart	וארט
homayoun	הומאיון
bksy	בקסי
hasek	האסיק
xavier	זייביאר
stewart	סטיוארט
buson	בוסון
deby	דבי
arlen	ארלין
shraga	שרגא
rigobert	ריגוברט
junko	ג'אנקו
kimi	קימי
albayyati	אלבאיאטי
mimi	מימי
maathai	מאתאי
desai	דסאי
myriam	מיריאם
heraclius	הראקליוס
jameson	ג'יימסון
nolberto	נולבירטו
rockmond	רוקמונד
sanou	סאנו
belkacem	בלקאסם
nash	נאש
bilal	בילאל
franky	פראנקי
shoaib	שועיב
dhiab	דיאב
meszoly	מיסזולי
transnistria	טראנסניסטריא
portas	פורטאס
nachshon	נחשון
troy	טרוי
tiger	טאיגר
mutiu	מוטיו
monsef	מונסף
jamieson	ג'מיסון
lassana	לאסאנא
gaskell	גאסקל
nabeel	נביל
gurpegui	גורפיגי
menegazzo	מיניגאזו
santini	סאנטיני
shaaban	שעבאן
aref	עארף
corleone	קורליוני
theodore	תיודור
coppola	קופולא
saqr	סאקר
fiona	פיונא
marathon	מאראתון
kettering	קיטירינג
so	סו
shaath	שעת
motoko	מוטוקו
gabbidon	גאבידון
silverstone	סילברסטון
iftar	איפטאר
nurhaliza	נורהאליזה
bonnissel	בוניסל
dulce	דולסי
harakat	חרקת
chuck	צ'אק
marrakchi	מראקשי
pakradouni	פקראדוני
aeroflot	אירופלוט
chekhov	צ'כוב
yonatan	יונתן
olmert	אולמרט
nouzaret	נוזארה
blaby	בלייבי
hidekatsu	הידיקאטסו
healey	הילי
kfar	כפר
cabrillo	קאברילו
corfu	קורפו
metropolitana	מטרופוליטאנא
afar	עפאר
montmartre	מונטמארטר
razak	רזק
kotoko	קוטוקו
noor	נור
buljan	בוליאן
mernissi	מרניסי
lurz	לורז
hicham	הישאם
masaccio	מאסאצ'ו
souza	סוזא
martelli	מארטילי
harari	הרארי
komljenovic	קומלינוביטש
metin	מיטן
georgia	ג'ורג'א
melanesia	מילאניזיא
valentia	ואלינטיא
tunisia	טוניסיה
papoulias	פאפוליאס
simonov	סימונוב
bunraku	בונראקו
czeslaw	צ'יסלאב
hall	הול
biella	ביילא
eden	עדן
apophis	אפופיס
scherzinger	שירזינגר
carrier	קאריאר
stifter	סטיפטר
toldo	טולדו
kant	קאנט
murawski	מוראוסקי
moteab	מוטעב
pinocchio	פינוקיו
yatom	יתום
vyntra	וינטרא
pipes	פאיפס
tortosa	טורטוסא
myskina	מיסקינא
missouri	מיזורי
shehu	שהו
kahn	קאהן
jundiaad	ג'ונדיאד
bijotat	ביג'וטאט
sukur	סוקור
magath	מאגאת
noether	נותר
mayumi	מאיומי
hakovesh	הכובש
mer	מר
maryland	מארילאנד
kiribati	קיריבאטי
der	דר
haysbert	הייזבירט
deveric	דיביריטש
ger	גר
fulci	פולקי
pepsi	פפסי
jimenez	חימנז
noriega	נורייגא
crowe	קרו
madre	מאדרי
elin	אלין
joya	ג'ויא
almodovar	אלמודובאר
battisti	באטיסטי
shosh	שוש
funke	פונקה
berry	בירי
davison	דאביסון
dunkirk	דאנקירק
vincent	וינסנט
voight	בויט
karami	קראמי
hoffman	הופמאן
bergougnoux	בירגוניו
lerby	לרבי
mottram	מוטראם
fiennes	פיאנס
norilsk	נורילסק
kazaz	קאזאז
dragonair	דראגונייר
bartolomeo	בארטולומיו
mdledle	מדלידלי
kazan	קאזאן
frederick	פרידיריק
combs	קומז
beslan	בסלאן
rogier	רוג'יר
francesco	פראנשיסקו
poncelet	פונסלה
rashomon	ראשומון
francesca	פראנססקא
zaven	זאבין
shinji	שינג'י
đuric	דוריטש
gorshkov	גורשקוב
chazz	שאז
amin	אמין
cossery	קוסרי
ana	אנא
ravier	ראוייר
moizan	מויזאן
jagdeo	ג'אגדיו
lesnar	ליסנר
fonseca	פונסיקא
facchetti	פאקיטי
boltzmann	בולצמאן
jafargholi	ג'עפרגולי
zib	זיב
bhutto	בוטו
ilana	אילנה
speed	ספיד
edward	אדוארד
grzegorz	גרזיגורז
gregoire	גריגויר
comte	קומט
johannes	יוהאנס
piccoli	פיקולי
nobutoshi	נובטושי
viorel	ויוריל
drazen	דראזין
galite	גאליטה
dib	דיב
benayahu	בנאיאהו
guenon	גוינון
palminteri	פאלמינטרי
adana	עדאנא
barnetta	בארניטא
conte	קונטי
capek	קאפק
capet	קאפה
doxa	דוקסא
nikoloudis	ניקולודיס
kamikawa	קאמיקאוא
catalani	קאטאלאני
danon	דאנון
mann	מן
nazar	נזאר
gann	גאן
pizarro	פיזארו
robertson	רוברטסון
tartarus	טארטארוס
baer	באיר
ricardo	ריקארדו
livnat	ליבנת
boniek	בוניק
speer	ספיר
henryk	הנריק
rainea	ראיניא
catalonia	קאטאלוניא
vassily	ואסילי
dickson	דיקסון
henrik	הנריק
michalik	מיכאליק
bianca	ביאנקא
eliza	אליזא
buckley	באקלי
gandhi	גאנדי
kasey	קייסי
balboa	באלבוא
levinson	לווינסון
peretz	פרץ
albayrak	אלבאירק
frasco	פראסקו
athanasius	אתנאסיוס
hellinger	הילנגר
cook	קוק
mokoena	מוקוינא
stelmach	סטילמאטש
frisk	פריסק
aguilar	אגוילאר
yaguchi	יאגוצ'י
wittmann	ויטמאן
dzeko	דזיקו
mcnab	מאקנאב
jasem	ג'אסם
namikawa	נאמיקאוא
mignogna	מיניונא
prudius	פרודיוס
fossey	פוסי
welter	ולטר
twal	טואל
confucius	קונפיושוס
mercosur	מירקוסור
malalai	מלאלאי
gillars	גילרז
cadillac	קאדילאק
mitanni	מיטאני
francois	פרנסוא
eleanor	אלאנור
andrea	אנדריא
shabazi	שבזי
zhuk	זהוק
raver	רייבר
northfield	נורתפילד
tatlin	טאטלין
maserati	מסיראטי
stoichkov	סטויצ'קוב
matilda	מאטילדא
mit	מיט
barthes	בארט
bit	ביט
golding	גולדינג
thaler	טאלר
piatti	פיאטי
javier	חאבייר
petronio	פיטרוניו
spain	ספיין
dupont	דופונט
woody	וודי
discovery	דיסקברי
morty	מורטי
volvo	וולבו
karkar	קארקאר
naser	נאסר
ferruccio	פירוצ'יו
henriksen	הנריקסן
cernan	סירנאן
morte	מורטי
mitsuaki	מיטסואקי
chaim	חיים
vyazma	ויאזמא
sokho	סוכו
kirshner	קירשנר
tariq	טאריק
serzh	סירז'
kinshasa	קינשאסא
meshir	משיר
mehanna	מהנא
vanessa	ואניסא
popper	פופר
lahham	לחאם
lamborghini	לאמבורגיני
munaron	מונארון
tarin	טארין
lessing	ליסינג
yves	איב
tarik	טאריק
brynjar	בריניאר
giacinto	ג'אסינטו
sarit	שרית
belyzel	ביליזל
paxton	פאקסטן
henman	הינמאן
tie	טאי
ljubinko	ליובינקו
patagonia	פאטאגוניא
giorgi	גיורגי
philadelphia	פילאדלפיא
lie	לאי
napolitano	נאפוליטאנו
hmam	חמאם
manuel	מאנויל
gamberini	גאמביריני
sarin	סארין
lori	לורי
mori	מורי
gertrude	גירטרוד
yoshino	יושינו
gamsakhurdia	גאמסאכורדיא
casey	קייסי
miroslav	מירוסלאב
adorno	אדורנו
basel	באסל
hleb	הליב
rashidi	רשידי
ammo	עמו
irakleio	איראקליו
cid	סיד
kouchner	קושנר
rulfo	רולפו
nocerino	נוצ'ירינו
alela	אלילא
nahariya	נהריה
reiner	ראינר
kaufmann	קופמאן
fransman	פראנסמאן
haris	חאריס
malfoy	מאלפוי
kanepi	קאניפי
valderrama	ואלדיראמא
blanc	בלאנק
holguin	הולגוין
jostein	ג'וסטאין
megalodon	מיגאלודון
stephon	סטיפן
karaboue	קאראבויה
norte	נורט
salvador	סלבאדור
grenada	גרינאדא
donizetti	דוניזיטי
nojima	נוג'ימא
vujovic	בויוביטש
thys	תיס
valon	ואלון
hjalmar	היאלמאר
aland	אלאנד
ernesto	ארנסטו
tassadit	טסעדיט
verkhoyansk	וירכויאנסק
diablo	דיאבלו
toumani	טומאני
barroso	בארוסו
osborn	אוסבורן
paphos	פאפוס
donskoy	דונסקוי
capello	קאפילו
nizam	ניזאם
katanec	קאטאניטש
nizar	ניזאר
fukui	פוקוי
alzheimer	אלזהאימר
huerta	הוארטא
dunstaple	דאנסטאפל
kendo	קנדו
tskhinvali	טסכינבאלי
benjamin	בנג'אמין
metzger	מצגר
buster	באסטר
dassault	דאסולט
milton	מילטון
doppler	דופלר
mapai	מפאי
pairetto	פאיריטו
hissene	חיסן
okuma	אוקומא
zangwill	זאנגויל
alcntara	אלקנטארא
mario	מאריו
marin	מארין
mccallany	מקאלאני
marie	מארי
tsabet	טסאבט
baekeland	ביקלאנד
sophocles	סופוקליז
maria	מאריא
yakubu	יאקובו
ramsay	ראמסיי
foggia	פוג'יא
pancoast	פנקוסט
makaay	מקאי
naveh	נוה
shikma	שיקמא
jacques	ז'ק
antar	ענטר
clarence	קלארנס
proust	פרוסט
haibin	האיבין
beilin	בילין
karim	קרים
karin	קארין
cristea	קריסטיא
lebron	ליברון
benedetto	בינידטו
marzouq	מרזוק
balhous	בלחוס
political	פוליטיקל
asik	אסיק
akkad	עקאד
miskito	מיסקיטו
forssmann	פורסמאן
shehzad	שהזאד
jableh	גבלה
gugino	גוגינו
madono	מאדונו
toro	טורו
lukacs	לוקאש
gregory	גריגורי
chalme	צ'אלמי
sethrida	סתרידא
stranzl	סטראנזל
flohe	פלוה
borgnine	בורגנין
platini	פלאטיני
rosario	רוזאריו
cheryl	שיריל
titov	טיטוב
ticleanu	טיקליאנו
fortaleza	פורטאליזא
hooke	הוק
karlsruhe	קארלסרוה
whelan	וילאן
danube	דאנוב
paulino	פאולינו
palmachim	פלמחים
didier	דידייה
kaimbi	קאימבי
polgar	פולגאר
harsanyi	הארסאני
bangalore	באנגאלור
mccartney	מקארטני
bissau	ביסאו
kirkilas	קירקילאס
teofilo	טיופילו
djite	דג'יטי
ethel	איתיל
tasso	טאסו
maier	מאיר
buigues	בויגיס
naveen	נאבין
shklovsky	שקלובסקי
hamsun	המסון
bardon	בארדון
sadat	סאדאת
dokhi	דוכי
alfa	אלפא
gavrilov	גאברילוב
stoltz	סטולץ
nkrumah	נקרומא
tajikistan	טאג'יקסטאן
vietnam	וייטנאם
zhao	ז'או
ojeili	עוג'יילי
gunnar	גונאר
deledda	דילידא
shao	שאו
colette	קוליט
melchiot	מילשיוט
narongchai	נארונגצ'אי
viduka	וידוקא
thorst	תורסט
endless	אנדליס
hanaoui	חנאוי
alfredo	אלפרידו
hamdani	חמדאני
slavko	סלאבקו
broz	ברוז
lewandowski	ליבאנדובסקי
safin	סאפין
dario	דאריו
babacar	באבאקר
horizonte	הוריזונטי
irit	אירית
gateshead	גייטסהיד
bayoumi	באיומי
middendorf	מידנדורף
hansson	האנסון
taye	טאי
kollontai	קולונטאי
sapunaru	סאפונארו
reveillere	ריביליר
kaye	קיי
bachelet	באשילה
yossef	יוסף
bek	בק
beth	בת
marina	מארינא
faye	פיי
sorrentino	סורנטינו
sales	סיילז
gottlob	גוטלוב
winograd	וינוגראד
hadar	הדר
hasse	האס
issyk	איסיק
vesnin	וסנין
hayabusa	האיאבוסא
baric	באריטש
kerrigan	קיריגאן
hafiz	חאפז
morrison	מוריסון
traore	טראורי
vitor	ויטור
hadad	חדאד
lucilio	לוסיליו
hartman	הארטמאן
zakopane	זאקופאנא
gnome	נום
hammond	האמונד
rigoberta	ריגובירטא
monfils	מונפיס
naoki	נאוקי
topi	טופי
jamel	ג'אמל
hafid	חפיד
vincente	וינסינט
naoko	נאוקו
potter	פוטר
schmid	שמיד
gish	גיש
breuer	ברויר
pisin	פיסין
almaimani	אלמאימני
monza	מונזא
tiomkin	טיומקין
anselm	אנסילם
meridor	מרידור
mikael	מיקאיל
lofthouse	לאפטהאוס
batistuta	באטיסטוטא
harold	הארולד
salpigidis	סאלפיגידיס
husayn	חוסיין
fukuyama	פוקויאמא
buscemi	בושימי
hoshino	הושינו
tahir	טאהיר
massa	מאסא
arutz	ערוץ
rosenbaum	רוזנבאום
khusainov	חוסיינוב
leah	ליה
timur	טימור
elsonbaty	אלסנבאטי
donato	דונאטו
bernd	בירנד
berne	ברן
garbarek	גארבארק
berni	בירני
leila	לילא
nakamura	נאקאמורא
farid	פריד
sahin	סאהין
charisteas	חאריסטיאס
redha	רדא
faris	פאריס
kadar	קאדאר
keaton	קיטון
laxness	לאקסנס
bonano	בונאנו
chalabi	צ'לבי
rosi	רוסי
daninos	דאנינוס
mizuki	מיזוקי
kiril	קיריל
hata	האטא
hashimoto	האשימוטו
eduardo	אדוארדו
hmede	חמידה
walton	ואלטון
franciscan	פרנסיסקן
richard	ריצ'ארד
cadherin	קאדהירין
mensah	מינסאה
skiles	סקאילז
mezzogiorno	מידזוגורנו
molnar	מולנאר
harada	האראדא
pamungkas	פאמונגקאס
yoshio	יושיו
mein	מיין
nein	נאין
clarkson	קלארקסון
hill	היל
ashour	עאשור
yusa	יוסא
behcet	בהקט
bill	ביל
kei	קיי
zakir	זאקיר
fontaine	פונטיין
liston	ליסטון
park	פארק
juliette	ג'וליאט
sark	סארק
musa	מוסא
major	מייגו'ר
low	לו
mark	מארק
motta	מוטא
shotokan	שוטוקאן
maclaine	מאקליין
magid	מגיד
casas	קאסאס
mulligan	מוליגאן
lajos	לאיוס
abbassi	עבאסי
bakari	באקארי
ishak	איסחאק
sforza	ספורזא
foote	פוט
dodi	דודי
yajima	יאג'ימא
amr	עמר
keach	קיטש
vahid	וחיד
simovic	סימוביטש
marulanda	מארולאנדא
jasmila	יאסמילא
frideric	פרידריק
hassanal	חסנל
hagai	חגי
denver	דנבר
diamond	דיאמונד
baalbek	בעלבק
moglen	מוגלין
jermain	ג'רמיין
belo	בלו
kubuntu	קובונטו
macanga	מאקאנגא
santos	סאנטוס
kaysone	קאיסון
desailly	דיסאיי
kiyoura	קיורא
golmohammadi	גולמוחמדי
birtles	בירטלז
warren	וארן
bakshi	באקשי
zahavi	זהבי
rajoelina	רג'ולינא
citigroup	סיטיגרופ
bondarenko	בונדארינקו
dugarry	דוגארי
ginola	גינולא
cartman	קארטמאן
magnin	מאגנין
bunche	באנש
ayoob	איוב
sonu	סונו
spencer	ספנסר
belqola	בלקולה
ramos	ראמוס
conceicao	קונסיסאו
takis	טאקיס
mellberg	מלבירג
noriaki	נוריאקי
moslem	מוסלם
woodley	וודלי
badar	בדר
maxi	מאקסי
jahin	ג'אהין
ramon	ראמון
corriere	קורייר
yoshihiro	יושיהירו
eva	איבא
haig	הייג
krauss	קראוס
sejdiu	סידיו
smicer	סמאיסר
alonzo	אלונזו
eames	אימז
pasdar	פאסדאר
soseki	סוסיקי
lule	לולי
crouch	קראוטש
apostol	אפוסטול
gbagbo	גבאגבו
daley	דיילי
chatwin	צ'אטוין
varlam	וארלאם
huggel	האגל
indian	אינדיאן
nanami	נאנאמי
scot	סקוט
handal	חנדל
duvall	דובאל
yacine	יאסין
darijo	דאריו
kagan	קאגאן
horus	חורוס
littbarski	ליטבארסקי
tatarstan	טאטארסטאן
fritz	פריץ
herzliya	הרצליה
roxas	רוקסאס
diab	דיאב
paul	פול
vidal	וידאל
kander	קאנדר
truman	טרומאן
balel	באלל
lansbury	לאנסבורי
lindfield	לינדפילד
aquitaine	אקויטיין
putnam	פוטנאם
hainan	האינאן
bentley	בנטלי
obsidian	אובסידיאן
barnaul	בארנול
troshkin	טרושקן
gillo	גילו
baley	באלי
hitchcock	היצ'קוק
kovac	קובאטש
dogg	דוג
masako	מאסאקו
lorimer	לורימר
svehlik	זביהליק
faudel	פאדל
shamekh	שאמך
burnley	בורנלי
lorca	לורקא
chao	צ'או
sabin	סאבין
balmer	באלמר
thissen	תיסן
rasputin	ראספיוטין
hakim	חאקים
lantos	לאנטוס
liv	ליב
windhoek	וינדהוק
giacomo	ג'אקומו
serotonin	סירוטונין
stjepan	סטיפאן
erez	ארז
lancaster	לאנקסטר
sese	סיסי
irina	אירינא
lucius	לוסיוס
ahmed	אחמד
maarouf	מערוף
wakim	ואקים
khallikan	חליקאן
miralem	מיראלם
munro	מונרו
peggy	פגי
galen	גיילן
zapater	זאפאטיר
davide	דביד
sprinzak	שפרינצק
kikuchi	קיקוצ'י
acuna	אקונא
bedjaoui	בג'אוי
miles	מאילז
baraja	באראכא
lochhead	לוקהד
zoellick	זוליק
debra	דיברא
silverstein	סילברסטאין
rovaniemi	רובאניאמי
sartre	סארטר
borussia	בורוסיא
alkane	אלקיין
zahra	זהרא
parfait	פארפاיט
sybille	סיביל
bazooka	באזוקא
vanunu	וענונו
takayuki	טאקאיוקי
bahir	בהיר
kumaratunga	קמאראטונגא
daihatsu	דאיהאטסו
romain	רומיין
riley	ראילי
toshio	טושיו
fiston	פיסטון
iroquois	אירוקויס
renner	רינר
grove	גרוב
scola	סקולא
rome	רום
sagisu	סאגיסו
natalie	נאטאלי
trevor	טריבור
lome	לום
maximus	מקסימוס
fehr	פיהר
ramamurthy	ראמאמורתי
raghib	ראגיב
briggs	בריגז
poom	פום
room	רום
gamzatov	גמזטוב
nantes	נאנטס
gotsmanov	גוטסמאנוב
luccin	לוקין
nidal	נידאל
eurosport	איורוספורט
zavarov	זאבארוב
selman	סלמאן
vecchio	ויקצ'יו
mugihito	מוגיהיטו
hameed	חמיד
dmitri	דמיטרי
partizan	פארטיזאן
bento	בינטו
hilary	הילארי
kroto	קרוטו
polak	פולאק
tobey	טובי
gorlitz	גורליץ
sheba	שיבא
suazo	סואזו
benitez	ביניטיז
loko	לוקו
dissa	דיסא
vancouver	ואנקובר
yano	יאנו
timor	טימור
tripoli	טריפולי
serafin	סראפין
antalya	אנטאליא
cisse	סיסי
lauren	לורן
callas	קאלאס
missaoui	מיסאוי
moniz	מוניז
sarsgaard	סארסגארד
enkhbayar	אנכבאיאר
rietveld	ריטוילד
baltimore	באלטימור
crayford	קרייפורד
keats	קיטס
rehnquist	רינקויסט
asahara	אסאהארא
vaziri	וזירי
pienaar	פינאר
linder	לינדר
yolande	יולאנד
thornton	תורנטון
raja	רג'א
allianz	אליאנז
simon	סאימון
buhari	בוהארי
tomislav	טומסלאב
cal	קאל
jodar	ג'ודאר
tivoli	טיבולי
lupescu	לופיסקו
henriette	הנרייט
laurens	לורנס
milner	מילנר
todenhofer	טודנהופר
rimon	רימון
ioannis	יואניס
sisley	סיסלי
dali	דאלי
kinnear	קיניאר
kostunica	קוסטוניקא
ritter	ריטר
ethane	אתיין
massamasso	מאסאמאסו
alice	אליס
konin	קונין
swinton	סוינטון
betancourt	ביטאנקורט
honduras	הונדוראס
lenny	לני
artzi	ארצי
malatesta	מאלאטיסטא
yuki	יוקי
dedekind	דידיקינד
humboldt	האמבולט
broadbent	ברודבנט
stefania	סטיפאניא
matovinovic	מאטובינוביטש
denizli	דניזלי
tare	טארי
miyano	מיאנו
kandahar	קנדהאר
koiso	קויסו
hesperides	היספירידיס
romney	רומני
ronit	רונית
antonescu	אנטוניסקו
kafur	קאפור
candide	קאנדיד
petain	פיטאן
shawki	שאוקי
norman	נורמאן
wark	וארק
stepan	סטיפאן
armenia	ארמיניא
fazlagic	פאזלאגיטש
dory	דורי
antarctic	אנטארקטיק
toufic	טופיק
vladimir	ולאדימיר
msarri	מסארי
zhi	ז'י
emile	אמיל
ryoko	ריוקו
shi	שי
papas	פאפאס
luis	לויס
riise	רייסה
knox	נוקס
kapo	קאפו
han	האן
branko	בראנקו
blum	בלום
kahana	כהנא
tuapse	טואפסי
fandel	פאנדל
tzipi	ציפי
lessig	ליסיג
chamakh	שמאך
karnataka	קארנאטאקא
arango	אראנגו
qalqilyah	קלקיליה
lowell	לואל
kotler	קוטלר
takaya	טאקאיא
nigam	ניגאם
limor	לימור
luyckx	לוקס
soros	סורוס
schindler	שינדלר
heihachiro	הייהאצ'ירו
xuri	קסורי
radanovic	ראדאנוביטש
stravinsky	סטראבינסקי
philippines	פיליפינז
shumei	שומיי
nicolita	ניוקליטא
awad	עוואד
vanderlei	ואנדרלי
mikio	מיקיו
otmar	אוטמאר
abraj	אבראג'
mikulas	מיקולאס
holst	הולסט
heichel	האישל
maurice	מוריס
murakami	מוראקאמי
moriri	מורירי
harrelson	הארלסון
polley	פולי
moeneeb	מוניב
ossetia	אוסטיא
domenech	דומיניק
tijani	טיג'אני
cube	קיוב
salam	סלאם
kary	קארי
mary	מרי
franjo	פראניו
harnik	הארניק
bernard	ברנאר
cary	קארי
juliet	ג'ולייט
busacca	בוסאקא
franco	פראנקו
nestor	נסטור
headey	הידי
maccabi	מכבי
rusudan	רוסודאן
kennedy	קינידי
metsu	מיטסו
grint	גרינט
jorginho	ג'ורג'יניו
cassavetes	קאסאביטז
nonacosane	נונאקוסיין
rama	ראמא
lung	לונג
watteau	ואטו
tertullian	טרטליאן
aung	אונג
lama	לאמא
mahler	מאהלר
rotaru	רוטארו
kentucky	קנטאקי
caracalla	קאראקלא
fama	פאמא
naeim	נעים
barusso	בארוסו
philippoussis	פיליפוסיס
cosmo	קוסמו
pardo	פארדו
morello	מורילו
capecchi	קאפיקי
albin	אלבין
velimir	ולימיר
vittorio	ויטוריו
junichi	ג'וניצ'י
aristides	אריסטידיס
nashef	נאשף
zviad	זביאד
flitter	פליטר
dagano	דאגאנו
clemens	קלימינז
radomir	ראדומיר
mula	מולא
klein	קלאין
lederberg	לידרברג
forman	פורמאן
ramirez	ראמיריז
petras	פטראס
jocelyn	גוסלין
kimberly	קימברלי
dany	דאני
rensing	רינסניג
penn	פן
svensson	סוינסון
makasa	מאקאסא
juhfiyah	ג'וחפיה
nahuatl	נאהואטל
reyes	רייס
asmahan	אסמהאן
pletikosa	פליטיקוסא
hirz	חירז
maloney	מאלוני
mulla	מולא
zheng	ז'נג
gila	גילא
titicaca	טיטיקאקא
moresby	מורסבי
đinđic	גינגיטש
nolan	נולאן
salomaa	סאלומא
petar	פיטאר
ľubos	לובוס
velazquez	וילאזקיז
jon	ג'ון
nonie	נוני
kherson	חירסון
morozevich	מורוזיביטש
don	דון
zerka	זרקא
congo	קונגו
florentin	פלורנטין
sven	סוון
kol	קל
brittany	בריטאני
palmas	פאלמאס
dolinsky	דולינסקי
lampros	לאמפורוס
wimmer	וימר
syngman	סינגמאן
pappe	פאפה
shearim	שיארים
dayro	דאירו
kuntz	קונץ
zivaljevic	זיבאלייביטש
yerushalmi	ירושלמי
bongo	בונגו
gemmrich	גימריטש
student	סטודנט
seedorf	סידורף
lissitzky	ליסיצקי
haniyeh	הניה
again	אגיין
hirobumi	הירובומי
hrithik	הריתיק
tomohiro	טומוהירו
hirofumi	הירופומי
takayama	טאקאיאמא
sirous	סירוס
cuauhtemoc	קואטימוק
meucci	מיוצ'י
selma	סלמא
colak	קולאק
chakvetadze	צ'אקויטאדזה
mao	מאו
phenylketonuria	פינאילקיטונוריא
mangnall	מאנגנאל
scotland	סקוטלאנד
tonetto	טוניטו
relmy	רילמי
murray	מרי
gladstone	גלאדסטון
melpomene	מילפומיני
yoko	יוקו
leibniz	לאיבנץ
luke	לוק
mariot	מאריוט
hairuddin	האירודין
hoko	הוקו
stoch	סטוטש
rochemback	רוצ'מבאק
marlborough	מארלבורו
darfur	דארפור
rachmaninoff	רכמאנינוף
rachel	רייצ'ל
fado	פאדו
jonathan	ג'ונתן
fazrul	פאזרול
askar	עסקר
paulus	פאולוס
peres	פרס
grazer	גרייזר
combin	קומבין
nakata	נאקאטא
zitouni	זייטוני
childs	צ'אילדז
damarcus	דאמארקוס
sarayoot	סאראיוט
myles	מאילז
gaborone	גאבורון
rita	ריטא
tajura	טאג'ורא
macmillan	מאקמילאן
labone	לאבון
dickens	דיקנז
lita	ליטא
nita	ניטא
dewey	דואי
jabi	ג'אבי
peltola	פלטולא
yorkshire	יורקשיר
gita	גיטא
temime	טמים
babi	באבי
mardy	מארדי
chanov	צ'אנוב
tetsu	טטסו
mitterrand	מיטיראן
bob	בוב
ajram	ע'גרם
alfred	אלפרד
revie	ריבי
prion	פריון
pasteur	פאסטור
ras	ראס
cohn	קון
sheraton	שראטון
hank	האנק
toshiki	טושיקי
derdiyok	דרדיוק
holmboe	הולמבוי
turunen	טורונין
lviv	לביב
kuznetsova	קוזנטסובא
husseini	חוסייני
kirk	קירק
suleiman	סוליימאן
shalala	שלאלא
kissinger	קיסינג'ר
bigon	ביגון
bakala	באקאלא
buarque	בוארק
yavne	יבנה
manama	מנאמה
cedric	סידריק
liamine	ליאמין
heggy	הגי
summer	סאמר
garbutt	גארבוט
sur	סור
sommeil	סומיל
osano	אוסאנו
pauleta	פאוליטא
jaafari	ג'עפרי
chandrika	צ'אנדריקא
rodin	רודאן
kais	קייס
malick	מאליק
klas	קלאס
loa	לוא
blas	בלאס
manfred	מאנפרד
kantaria	קנטאריא
vojislav	וויסלאב
goa	גוא
santi	סאנטי
zhvania	ז'באניא
jehad	ג'האד
cho	צ'ו
houston	היוסטן
brett	בריט
srecko	סריצ'קו
twain	טויין
luxembourg	לוקסמבורג
nevzlin	ניבזלין
lamberto	לאמברטו
howard	האוארד
mahesh	מאהש
hesham	השאם
hasharon	השרון
khouloud	חולוד
zverev	זביריב
cuneo	קוניו
tsuji	צוג'י
tacconi	טאקוני
azizi	עזיזי
bracci	בראקי
suliman	סולימאן
lovric	לובריטש
convey	קונביי
jens	ינס
remez	רמז
bruckner	ברוקנר
attias	אטיאס
lange	לאנג
adelstein	אדלסטין
matrai	מאטראי
ihara	איהארא
wouters	ווטרס
rocchi	רוקי
delmotte	דילמוטי
seigo	סייגו
urey	יורי
greta	גריטא
burdenski	בורדינסקי
harkus	הארקוס
valdir	ואלדיר
ardashir	ארדשיר
gargano	גארגאנו
dessau	דיסאו
craxi	קראקסי
southend	סאותאנד
troussier	טרוסיה
wiener	וינר
kollhoff	קולהוף
gago	גאגו
karembeu	קארימבו
wren	רן
lazaros	לאזארוס
hudhayfah	חודייפה
elisha	אלישע
hemed	חמד
elista	אליסטא
sverre	סוירי
haiti	האיטי
kotarba	קוטארבא
thijssen	תיסין
bakhoum	באכום
alabama	אלאבאמא
hansen	האנסן
hermann	הירמאן
tannenbaum	טאננבאום
donnie	דאני
irwin	אירוין
khayyam	חיאם
tzonis	טזוניס
hasni	חסני
kingsley	קינגסלי
juninho	ג'ונינהו
heigl	היגל
rogge	רוג
markus	מארקוס
jerko	ג'רקו
pepe	פפה
grainger	גריינג'ר
renate	רינאט
squillaci	סקוילאצ'י
cioran	סיוראן
bursac	בורסאטש
klibi	קליבי
canada	קנדא
banksy	באנקסי
kav	קאב
zainab	זיאנב
turkmani	טורקמאני
grenoble	גרינובל
petric	פטריטש
miljoona	מילג'ונא
cavendish	קאבנדיש
beatrix	ביאטריקס
zelin	זילין
fletcher	פליטשיר
hazboun	חזבון
saveljic	סאבילייטש
nakache	נקאש
tanju	טאנג'ו
masny	מאסני
rehovot	רחובות
nyathi	ניאתי
rivera	ריבירא
shirley	שירלי
suu	סו
manitoba	מאניטובא
guarneri	גוארניירי
keren	קרן
patrik	פאטריק
gattuso	גאטוסו
rod	רוד
garde	גארד
nodia	נודיא
makoun	מאקון
dinant	דינאנט
jonquet	ג'ונקויט
astro	אסטרו
cabrita	קאבריטא
osseiran	עוסייראן
mahdavikia	מהדאוויקיא
leigh	לי
sanjo	סאנג'ו
gehan	גיהאן
bonetto	בוניטו
giancarlo	ג'אנקארלו
kornel	קורנל
salviati	סאלביאטי
baghdadi	בגדאדי
narendra	נארינדרא
guernsey	גירנזי
coffi	קופי
xun	שון
hiroyuki	הירויוקי
goldblum	גולדבלום
ohara	אוהארא
zbanic	זבאניטש
kyrenia	קיריניא
codrea	קודריא
lukashenko	לוקאשינקו
dodik	דודיק
trapattoni	טראפאטוני
loukas	לוקאס
jubayr	ג'ובאיר
charis	קאריס
greenberg	גרינבירג
madeleine	מאדלין
piszczek	פיזשיק
klinger	קלינגר
gharib	גאריב
irne	אירן
yaqub	יעקוב
alalwani	אלעלואני
davies	דייביז
zoi	זוי
quidde	קויד
arne	ארני
jigoro	ג'יגורו
calder	קאלדר
nemec	נימיטש
joseba	ג'וסיבא
olympus	אולימפוס
boban	בובאן
neeman	נימאן
nalbandian	נאלבאנדיאן
cesaire	סיזיר
trinidad	טרינידאד
chepita	צ'פיטה
giovanni	ג'ובאני
larter	לארטר
fiedler	פידלר
hasenclever	האסנקליבר
khaled	חאלד
dileita	דילייטא
kreuzer	קרוזר
hino	הינו
rahmati	ראמאטי
nino	נינו
baldur	באלדור
woese	ווס
ruud	רוד
gino	ג'ינו
adel	עאדל
bacary	בקארי
nouadhibou	נואדיבו
gamliel	גמליאל
painton	פיינטון
albahri	אלבחרי
gygax	גיגאקס
puglisi	פוליזי
reik	רייק
roraima	רוראימא
klimov	קלימוב
selim	סלים
matthew	מאתיו
lorenzo	לורינזו
kenan	קינאן
helga	הילגא
lippi	ליפי
sagna	סאניא
ghassan	גסאן
clifton	קליפטון
marketa	מארקיטא
krychowiak	קריצ'וביאק
dillon	דילון
dili	דילי
mahdi	מהדי
gili	גילי
olga	אולגה
chingy	צ'ינגי
becky	בקי
hendrie	הינדרי
hai	האי
grichting	גריקטינג
mai	מאי
stavanger	סטאבאנג'ר
bai	באי
peguy	פיגוי
gabriel	גבריאל
brocchi	ברוקי
paine	פיין
calleja	קאליכא
shlaim	שלאים
phoenix	פיניקס
norbert	נורברט
rutland	רוטלאנד
kinmochi	קינמוצ'י
pire	פיר
malta	מאלטא
adelman	אדלמאן
yarkoni	ירקוני
micrometre	מיקרומטר
valdez	ואלדיז
macdowell	מאקדאול
diabate	דיאבייט
calimero	קאלימירו
dire	דאיר
sadler	סאדלר
gaudi	גאודי
liebermann	ליברמאן
pfannkuch	פפאנקוטש
postiga	פוסטיגא
behtash	בהטאש
spacey	ספייסי
athletic	אתלטיק
harry	הארי
elbert	אלברט
lundgren	לאנדגרין
anastasia	אנאסטייז'ה
meciar	מיצ'יאר
dryden	דראידן
kieron	קירון
nobusuke	נובוסוקה
clift	קליפט
mcfadden	מקפאדין
kieran	קיראן
torben	טורבין
benoit	בינוא
masayoshi	מאסאיושי
pike	פאיק
holland	הולאנד
heidelberg	האידלברג
gagarin	גאגארין
melanie	מילאני
cabel	קאבל
ghosn	גוסן
florence	פלורנס
wilkins	וילקינז
thomson	טומסון
queudrue	קודרו
zachary	זאקארי
faith	פיית
facundo	פאקונדו
yusuf	יוסוף
matsuo	מאטסוו
magno	מאגנו
nice	ניס
coulais	קולייס
saint	סיינט
lamont	לאמונט
ramla	רמלה
avalon	אבאלון
galbraith	גאלבריית
fillon	פיון
orlov	אורלוב
castillo	קאסטילו
munch	מונק
rutan	רוטאן
shockley	שוקלי
sargon	סרגון
terrence	טירינס
pena	פינא
pininfarina	פינינפארינא
rena	רינא
ebonite	אבונייט
leviev	לבייב
morita	מוריטא
glynn	גלין
gong	גונג
alexei	אליקסיי
orhan	אורהאן
hossein	חוסין
aissati	עיסאטי
faustino	פוסטינו
kirschen	קירשן
cena	סינא
slaven	סלאבין
matza	מצה
minoungou	מינונגו
brukhin	ברוכין
adolph	אדולף
diao	דיאו
perelman	פרלמאן
triple	טריפל
graf	גראף
flynn	פלין
mistral	מיסטראל
genghini	גינגיני
yehuda	יהודא
balbo	באלבו
chamanga	צ'אמאנגא
hrawi	הראוי
segolene	סיגולין
walters	ואלטרז
natsume	נאטסומה
osama	אוסאמה
freddy	פרידי
hima	הימא
banjo	באנג'ו
peyton	פייטון
robeson	רובסון
asparagine	אספאראגין
doyle	דויל
dima	דימא
stiller	סטילר
ercolano	ארקולאנו
ljubicic	ליוביסיטש
rawhi	ראוחי
karpenko	קארפינקו
flaherty	פלאהירטי
courteney	קורטני
jutland	גו'טלאנד
rothbard	רותבארד
vlasov	ולאסוב
ferdinando	פרדינאנדו
shawqi	שאוקי
trabzon	טראבזון
tal	טאל
randy	ראנדי
val	ואל
hal	האל
kal	קאל
lal	לאל
havana	האבאנא
bal	באל
etna	אטנא
niemoller	נימולר
tenzing	טינסינג
tarek	טארק
balta	באלטא
sumer	סומר
kathy	קאתי
jelinek	יליניק
carmen	קארמן
fortuyn	פורטוין
izhar	איזהאר
yulia	יוליא
mildred	מילדריד
pasulko	פאסולקו
mainz	מיינז
turbo	טורבו
rumer	רומר
dejan	דיג'אן
rubicon	רוביקון
aalto	אלטו
vesely	ויסלי
leto	ליטו
prunier	פרונייה
maine	מיין
huth	הות
turnham	טורנהאם
idaho	אידאהו
kafr	קאפר
delic	דיליטש
boiany	בויאני
mansfield	מאנספילד
anders	אנדרז
bugatti	בוגאטי
koch	קוך
korban	קורבן
shah	שאה
chyler	טשילר
wyoming	ויומינג
ducommun	דוקומון
karren	קארין
safra	ספרא
ferrary	פירארי
neruda	נירודא
safri	ספרי
seri	סרי
janine	ג'אנין
mashhur	משהור
sartawi	סרטאווי
kenshin	קינשין
mileva	מיליבא
guus	גוס
neri	נירי
camillo	קאמילו
zion	זאיון
williams	ויליאמס
carre	קארה
yedid	ידיד
kissufim	כיסופים
shiozawa	שיוזאוא
spelling	ספילינג
schwarzenegger	שוארצניגר
boulahrouz	בולאחרוז
bettino	בטינו
hojeij	חוג'ייג'
pasternak	פאסטרנאק
hamburg	האמבורג
kvasnak	קבאסנאק
hunt	האנט
rowland	רולאנד
cabrini	קאבריני
debbas	דבאס
kebe	קבה
hadji	חאג'י
barro	בארו
yukiko	יוקיקו
parkour	פארקור
lavon	לאבון
farman	פארמאן
livni	ליבני
mohamed	מוחמד
heyerdahl	האירדאל
chansa	צ'אנסא
kosuke	קוסוקי
brehme	ברימה
sargsyan	סרגסיאן
connelly	קונילי
damien	דאמיאן
ireland	אירלנדא
neal	ניל
bancarel	באנקאריל
artur	ארטור
fathi	פתחי
eido	עידו
strait	סטרייט
sadeq	סאדק
ibrahim	איבראהים
yuba	יובא
montella	מונטילא
takfiri	טקפיריה
gershwin	גירשוין
patricio	פאטריסיו
zeidan	זיידאן
tusun	טוסון
vonlanthen	וונלאנתן
dusseldorf	דוסלדורף
narazaki	נאראזאקי
allyson	אליסון
hanson	האנסון
felix	פיליקס
jackman	ג'אקמאן
yakovlev	יאקובליב
tikva	תקוה
ronde	רונד
pascale	פאסקאל
lothar	לותאר
tibi	טיבי
zoff	זוף
allan	אלאן
kaviedes	קאבידס
greco	גריקו
bibi	ביבי
yao	יאו
rachad	ראצ'אד
hartfield	הארטפילד
ulihrach	יוליהראטש
ralph	ראלף
sao	סאו
medawar	מדוור
brundle	בראנדל
hendrik	הנדריק
hao	האו
avtovaz	אבטובאז
fanous	פאנוס
grondona	גרנדונא
leyton	לייטון
enos	אינוס
cao	קאו
dao	דאו
pink	פינק
doron	דורון
belgrade	בלגראד
vink	וינק
manmohan	מאנמוהאן
gizenga	גיזינגא
crvenkovski	קרבינקובסקי
dis	די
malkin	מאלקין
kanaan	כנען
ridgewell	רידג'וול
rincon	רינקון
sarrionandia	סאריונאנדיא
fulton	פולטון
barron	בארון
memering	מימירנג
fire	פאיר
cavell	קאביל
manson	מאנסון
brunelleschi	ברונליסקי
ibiza	איביזא
saadi	סעדי
rivilla	ריבילא
safina	סאפינה
halilhodzic	חלילהודזיטש
bataysk	באטאיסק
hiroki	הירוקי
branson	בראנסון
tainio	טאיניו
surtees	סורטיס
wehr	ור
khamees	חמיס
schwartzman	שוארmמן
netolicka	ניטוליקא
katalinski	קאטאלינסקי
stylites	סטאילאיטס
scarpa	סקארפא
bullard	בולארד
moratti	מוראטי
oulmou	אולמו
tugendhat	טוגנדהאט
hilu	חילו
elsanhuri	אלסנהורי
vermont	ורמונט
beatrice	ביאטריס
nostradamus	נוסטראדאמוס
wakamoto	ואקאמוטו
asamoah	אסאמוא
davor	דאבור
heurelho	הורילהו
agrippa	אגריפא
naqqash	נקאש
hart	הארט
hardy	הארדי
kowalewski	קואלוסקי
koyamada	קויאמאדא
gascony	גאסקוני
bart	בארט
deleuze	דלוז
monde	מונד
westminster	וסטמינסטר
nuur	נור
adan	אדן
hakikar	האקיקאר
robert	רוברט
kotoku	קוטוקו
halutz	חלוץ
shamkhani	שאמכאני
totti	טוטי
ndadaye	נדאדאי
sulim	סולים
zvonareva	זבונאריבא
nitza	ניצה
hokkaido	הוקאידו
rossana	רוזאנא
mendoza	מנדוזא
kondo	קונדו
chandler	צ'אנדלר
schiffer	שיפר
stephane	סטיפאן
gascoigne	גאסקוין
rexhep	רג'פ
detroit	דיטרויט
reda	רדא
kasyanov	קאסיאנוב
nernst	נרנסט
nuwas	נוואס
baal	בעל
neda	נדא
beda	בידא
tokelau	טוקילאו
heraklion	היראקליון
nishikori	נישיקורי
cristian	קריסטיאן
dalmatia	דאלמיישא
cipollini	צ'יפוליני
jessica	ג'סיקא
recoba	ריקובא
southampton	סאותהאמפטון
sirkin	סירקן
wiland	וילאנד
figo	פיגו
mardi	מארדי
schuttler	שוטלר
shiningayamwe	שינינגאיאמוי
zaccardo	זקארדו
pickett	פיקיט
moreno	מורינו
valeriy	ואלירי
radcliffe	ראדקליף
bilharz	בילהארץ
rica	ריקא
szymborska	שימבורסקא
zang	זאנג
verheyen	וירהיין
seeldrayers	סילדראירס
munoz	מונוז
zaragoza	זאראגוזא
gabriele	גאבריאל
dica	דיקא
bin	בין
susumu	סוסומו
moncayo	מונקאיו
ryotaro	ריוטארו
nonda	נונדא
vautrot	ואוטרוט
weill	ויל
miura	מיורא
cher	שיר
ziv	זיו
lugano	לוגאנו
ivanovic	איבאנוביטש
ataturk	אטאטורק
irad	איראד
romano	רומאנו
viv	ויו
balkan	בלקאן
moravcik	מוראבצ'יק
grybauskaite	גריבאוסקאיטי
niv	ניב
viale	ויאלי
taub	טאוב
hammerfest	האמרפיסט
meriah	מריאח
mauritania	מוריטייניא
andranik	אנדראניק
timlin	טימלין
nishimura	נישימורא
nsibambi	נסיבאמבי
caravelli	קראבילי
ifeanyi	איפאניי
boyle	בויל
shevardnadze	שיברדנאדזה
jermaine	ג'רמיין
lance	לאנס
karadeniz	קאראדינז
perusini	פירוסיני
martha	מארתא
arae	אראי
hayami	האיאמי
brunner	ברונר
colfax	קולפאקס
arshavin	ארשאבין
leiden	לידין
katsura	קאצורא
sudan	סודאן
greengrass	גרינגראס
westinghouse	וסטינגהאוס
cutty	קאטי
dariusz	דאריוש
almurshid	אלמורשיד
luciano	לוסיאנו
velasquez	וילאסקיז
oppenheimer	אופנהימר
manolete	מאנוליטי
sarah	סארה
zuhr	זוהר
richter	רישטר
andrey	אנדריי
lennon	לנון
pflugler	פפלוגלר
janusz	יאנוש
yaqut	יאקוט
belaya	בילאיא
simin	סימין
julio	יוליו
mato	מאטו
hofmann	הופמאן
mitsumasa	מיטסומאסא
olimpia	אולימפיא
bauer	באוור
dre	דרי
elisabeth	אליזאבת
riemann	רימאן
kalman	קאלמאן
ramayana	ראמאיאנא
liguria	ליגוריא
geza	גזא
iraola	איראולא
steve	סטיב
theropoda	תירופודא
guerreiro	גוירירו
ney	ניי
dolittle	דוליטל
dubinski	דובינסקי
bey	ביי
hammill	האמל
dey	דיי
mcneil	מקניל
yamani	ימאני
sharett	שאריט
husain	חוסיין
luxemburgo	לאקסומבורגו
dmitry	דמיטרי
nanbudo	נאנבודו
owen	אוין
ouarzazate	ורזאזאת
bergson	ברגסון
katowice	קאטויסא
cardo	קארדו
faulkner	פולקנר
friedel	פרידל
gesher	גשר
nadine	ניידין
hellenic	היליניק
mega	מגא
mazzola	מאצולא
madrid	מדריד
fadl	פאדל
bergomi	בירגומי
stahl	סטאל
mudi	מודי
piotr	פיוטר
soddy	סודי
medvedev	מידבידיב
deutsche	דוטש
maggie	מאגי
hibbert	היברט
tito	טיטו
alloudi	עלודי
turkish	טורקיש
taarabt	טאראבט
castonier	קאסטוניר
bassel	באסל
pauline	פולין
concorde	קונקורד
zuckmayer	צוקמאיר
takeo	טאקיו
sidqi	סידקי
bugalo	בוגאלו
fizeau	פיזו
marat	מאראט
terzanidis	טירזאנידיס
pyotr	פיוטר
ilan	אילן
khader	חאדר
hiroshima	הירושימא
lincoln	לינקולן
mariana	מאריאנא
enric	אנריק
quzman	קוזמאן
ernst	ארנסט
sfax	ספאקס
still	סטיל
teng	טנג
shams	שאמס
maxwell	מאקסויל
margarete	מארגרט
luisao	לויסאו
turing	טורינג
cedrick	סידריק
weinek	ויניק
belhadj	בלחאג'
deng	דינג
pilguy	פילגוי
zarruq	זרוק
vialli	ויאלי
guojohnsen	גוג'ונסון
deen	דין
jashari	ישארי
shannon	שאנון
potito	פוטיטו
karan	קאראן
pradesh	פראדיש
carbonic	קרבוניק
isaac	איזאק
judah	ג'ודה
podgorica	פודגוריקא
metreveli	מיטריבילי
basinger	באסינגר
samantha	סאמאנתא
camelot	קאמלוט
jorg	ג'ורג
shawky	שוקי
harun	הארון
alsiqilli	אלסיקילי
jlloyd	ג'לויד
tenerife	טנריף
hidegkuti	הידיקוטי
kremer	קרימר
marcello	מארצ'לו
tawil	טוויל
bahram	בהראם
franklyn	פראנקלין
braxton	בראקסטון
catherine	קאתירין
guanghu	גואנגהו
ambrose	אמברוס
sexton	סקסטון
calais	קאלה
avner	אבנר
mwai	מואי
popa	פופא
carniglia	קארניגליא
matsuda	מאטסודא
temsamani	טמסמאני
trentino	טרינטינו
pyongyang	פיונגיאנג
lipchitz	ליפשיץ
liman	לימאן
kopa	קופא
hester	הסטר
jozef	ג'וזף
dulaim	דוליים
cardenosa	קארדינוסא
copa	קופא
nachbar	נאכבאר
micheľ	מיכיל
cleary	קלירי
skarmeta	סקארמיטא
tekle	טקלה
liaoning	לאיונינג
satoru	סאטורו
delbruck	דלברוק
galliani	גאליאני
simferopol	סימפירופול
alshahid	אלשהיד
entebbe	אנטבה
cavanna	קאבאנא
ghayeghran	גאיגראן
kamiya	קאמיא
solari	סולארי
maslyonkin	מאסליונקן
palop	פאלופ
dwomoh	דוומוה
johanna	יוהנא
beye	בייה
diderik	דידריק
shaobo	שאובו
villegas	ויליגאס
godfrey	גודפרי
solano	סולאנו
daraa	דרעא
alansari	אלאנסארי
shaarawi	שעראוי
goethe	גתה
sukhumi	סוכומי
judd	ג'אד
hojo	הוג'ו
cattermole	קאטרמול
grass	גראס
burgnich	בורגניטש
kazantzakis	קאזאנצאקיס
nazem	נאזם
maurizio	מוריזיו
rem	רים
avni	אבני
heidi	האידי
jordao	חורדאו
lem	לם
bolzano	בולזאנו
huchel	הוכל
budan	בודאן
hikaru	היקארו
geffen	גפן
arun	ארון
braun	בראון
tankian	טאנקיאן
merton	מירטון
grun	גרון
barak	ברק
dawoud	דאוד
stiliyan	סטיליאן
grimsson	גרימסון
niflheim	ניפלהאים
modeste	מודיסטי
waske	ואסקי
bejbl	בייבל
osman	עוסמאן
larnaca	לארנקא
niclas	ניקלאס
la	לא
vercingetorix	ורסינגיטוריקס
hobart	הובארט
ba	בא
exxon	אקסון
lil	ליל
piatra	פיאטרא
oil	אויל
mohajerani	מוהאג'ראני
gil	גיל
daudet	דודה
vojta	בויטא
albari	אלבארי
gwen	גוין
simunic	סימוניטש
lillehammer	לילהאמר
jerzy	יירזי
kublai	קובלאי
hidalgo	הידאלגו
pakito	פאקיטו
baresi	באריזי
parma	פארמא
adriana	אדריאנא
mauss	מאוס
nassar	נסאר
haney	הייני
vermes	ורמס
fazekas	פאזיקאס
garay	גאראי
naor	נאור
kittisak	קיטיסאק
dietz	דיץ
carney	קארני
miran	מיראן
zenko	זינקו
doug	דוג
faraj	פרג'
sahar	סחר
lilian	ליליאן
jeffrey	ג'פרי
agatha	אגאתא
roche	רוש
toronto	טורונטו
bucharest	בוכארסט
toulouse	טולוז
mahmud	מחמוד
sahab	סחאב
par	פאר
godwinson	גודוינסון
naumann	נאומאן
dudu	דודו
nilsson	נילסון
lamari	לאמארי
khoren	חורין
piquionne	פיקיון
mikkel	מיקל
christanval	קריסטאנבאל
rosa	רוזא
babacan	באבאקאן
vizek	ויזיק
kiran	קיראן
jenner	ג'נר
kanu	קאנו
aimar	אימאר
hilditch	הילדיטש
google	גוגל
ritchie	ריצ'י
manet	מאנה
pompeu	פומפיו
seif	סיף
akihito	אקיהיטו
baker	בייקר
alhamadi	אלחמאדי
manea	מאניע
spina	ספינא
zachariah	זאכאראיא
claudia	קלאודיא
yuichi	יויצ'י
elachi	אלעשי
bonaire	בונייר
tyrol	טירול
harris	האריס
beenhakker	בינהאקר
bultmann	בולטמאן
montgomery	מונטגומרי
kleiber	קליבר
clijsters	קלאיסטרז
costinha	קוסטינהא
efron	אפרון
sealy	סילי
schumpeter	שומפיטר
kenichi	קיניצ'י
basile	באסיל
asti	אסטי
bassila	באסילא
belozoglu	בילוזוגלו
esti	אסטי
malot	מאלו
demba	דימבא
stephenson	סטיפנסן
joleon	ג'וליון
mokhtari	מוחטארי
sophia	סופיא
janez	ג'אניז
legrottaglie	ליגרוטאלי
satoshi	סאטושי
unesco	יוניסקו
takeuchi	טאקיוצ'י
matsuoka	מאטסוקא
yanai	ינאי
regueiro	ריגיירו
tyrosine	טירוסין
shukeiri	שוקיירי
kazimir	קאזימיר
dianne	דאיאן
chovanec	צ'ובאניטש
kakhi	קקי
tsuyoshi	טסויושי
oswald	אוסואלד
wonder	וונדר
darby	דארבי
nesterov	נסטרוב
mahal	מחל
kalou	קאלו
mariano	מאריאנו
waksman	ואקסמאן
halley	האלי
hiro	הירו
rio	ריו
belqas	בלקאס
mordor	מורדור
australia	אוסטראליא
elhanan	אלחנן
dailly	דיילי
kata	קטע
nambaryn	נאמבארין
musemic	מוסימיטש
veliko	וליקו
jaloo	ג'אלו
imlay	אימליי
hurndall	הרנדל
montero	מונטירו
rednic	רידניק
cole	קול
jochi	ג'וטשי
hinkel	הינקל
fauci	פוסי
bruno	ברונו
ryokichi	ריוקיצ'י
lammens	לאמנס
annie	אני
foreman	פורמאן
frida	פרידה
mcmahon	מקמאהון
ludza	לודזא
sardinia	סרדיניא
jahan	ג'האן
tillman	טילמאן
best	בסט
hyundai	היונדאי
birak	ביראק
teerasil	טיראסיל
tojo	טוג'ו
pennac	פנאק
masaru	מאסארו
hirohito	הירוהיטו
hori	הורי
tamim	תמים
shelley	שלי
mclachlan	מקלאקלאן
louisiana	לויזיאנא
levy	לוי
caracas	קאראקאס
hamdan	חמדאן
cori	קורי
samir	סמיר
garbo	גארבו
lily	לילי
nixon	ניקסון
valdis	ואלדיס
khamis	חמיס
nanninga	נאנינגא
krueger	קרוגר
valdes	ואלדז
bernoulli	בירנולי
samih	סמיח
nicolet	ניקולה
emilio	אמיליו
baghdad	בגדאד
bosch	בוש
nicola	ניקולא
fumihiko	פומיהיקו
forsskal	פורסקאל
james	ג'יימז
karmi	כרמי
yaounde	יאונדי
nahal	נחל
ramin	ראמין
tartus	טרטוס
mantell	מאנטל
songul	סונגול
banel	באניל
guesdon	גויסדון
heisserer	הייסרר
tommot	טומוט
wilander	וילנדר
hertz	הרץ
shagari	שאגארי
muhammadu	מוחמדו
seale	סיל
oncken	אונקין
matias	מאטיאס
bradbury	בראדברי
okafor	אוקאפור
caillebotte	קאייבוט
fechner	פכנר
dahab	דהב
mizrahi	מזרחי
firas	פיראס
nielsen	נילסן
corrigan	קוריגאן
rupert	רופרט
hamid	חמיד
ballesta	באייסטא
rousseau	רוסו
caine	קיין
djokovic	דג'וקוביטש
gotthelf	גוטהילף
murtala	מורטאלא
marconi	מארקוני
nebraska	נבראסקא
piscator	פיסקאטור
delaney	דילייני
lynne	לין
crippen	קריפן
sarkozy	סארקוזי
ganea	גאניא
tierney	טירני
buganda	בוגאנדא
conakry	קונאקרי
asher	אשר
gould	גולד
badalona	באדאלונא
bikey	באיקי
taheyya	טחיה
bahar	בחר
meriem	מרים
titus	טאיטוס
calcutta	קאלקוטא
suttner	סוטנר
johnston	ג'ונסטון
binyamin	בנימין
sayaka	סאיאקא
mcguinness	מאקגינס
akrour	עקרור
matadi	מאטאדי
mel	מל
sculli	סקולי
talfah	טלפאח
lillian	ליליאן
qanso	קאנסו
lupe	לופ
hydrographic	האידרוגראפיק
bauhaus	באוהאוס
guevara	גווארא
getulio	גיטוליו
montenegro	מונטיניגרו
derrida	דרידא
ravshan	ראבשאן
tolstoy	טולסטוי
lukoil	לוקויל
day	דיי
plasil	פלאסיל
mavros	מאברוס
gerd	גרד
berkley	בירקלי
lamia	לאמיא
benenson	ביניסון
carrasso	קאראסו
foiros	פוירוס
tuscany	טוסקאני
mihaly	מיהאלי
corver	קורבר
piroxicam	פירוקסיקאם
noam	נועם
hancock	האנקוק
kamil	קאמל
jahsh	ג'חש
orleans	אורלינז
marciano	מארסיאנו
phillips	פיליפס
phau	פאו
shatili	שאטילי
avraham	אברהם
gunter	גונטר
haden	היידן
geronimo	ג'ראנימו
dawood	דאוד
witold	ויטולד
fuller	פולר
julie	ג'ולי
kirchner	קירשניר
fahad	פהד
jamie	ג'יימי
sanaa	סאנא
grace	גרייס
menashe	מנשה
jankulovski	יאנקולובסקי
hubert	היוברט
jawad	ג'אואד
kavazashvili	קאבאזאשבלי
krutikov	קרוטיקוב
dwight	דואיט
sulayman	סלימאן
kaneto	קאניטו
mitch	מיטש
gustave	גוסטאב
zakat	זקאת
devendra	דיבינדרא
sulaiman	סוליימן
odense	אודנסי
peel	פיל
camden	קאמדן
dzodzuashvili	דזודזואשבילי
peruzzi	פירוצי
bashi	באשי
dionysius	דיוניסיוס
lupolianski	לופוליאנסקי
oslo	אוסלו
taylor	טיילור
koki	קוקי
shepherd	שיפארד
blazej	בלאזיי
miyake	מיאקי
namie	נאמי
bourbaki	בורבאקי
stefan	סטיפאן
jihai	ג'יהאי
eitan	איתן
sbarro	סבארו
mcdormand	מקדורמאנד
sean	שון
pagnol	פאניול
sorin	סורין
hanan	חנאן
quaresma	קואריסמא
ashley	אשלי
jean	ג'ין
columbus	קולומבוס
lean	לין
zeezee	זיזי
yoshimoto	יושימוטו
wynalda	וינאלדא
bodart	בודארט
vasyl	ואסיל
jardel	ג'ארדל
william	ויליאם
suchoparek	סוצ'ופאריק
azizou	עזיזו
karamanlis	קאראמנליס
parreira	פארירא
kuka	קוקא
luka	לוקא
gelsenkirchen	גילסנקירשן
bois	בווא
nathaniel	נאתאניאל
causio	קאוזיו
maksim	מאקסים
graeme	גראם
piontek	פיונטיק
billie	בילי
soyuz	סויוז
kate	קייט
mate	מאטי
slobodan	סלובודאן
seville	סיביל
nihat	ניהאט
dawson	דוסן
momcilo	מומסילו
kjeld	קילד
binet	בינה
kahneman	קאהנמאן
stankovic	סטאנקוביטש
yoichiro	יויצ'ירו
klaipeda	קלאיפידא
barbera	בארבירא
takano	טאקאנו
barbara	בארברא
luanda	לואנדא
daiki	דאיקי
leib	ליב
bakar	בקר
torelli	טורילי
emek	עמק
stan	סטאן
sambora	סאמבורא
hamouche	חמוש
zouagi	זואגי
zuse	זוס
insulin	אינסולין
lepiller	ליפיליר
maresca	מאריסקא
bamir	באמיר
togashi	טוגאשי
paro	פארו
cronenberg	קרוננברג
zack	זאק
mental	מינטאל
orwell	אורויל
balmont	באלמונט
djvu	דג'בו
konstantinou	קונסטאנטינו
portman	פורטמאן
rageh	ראגח
aamir	עאמיר
sambusac	סמבוסק
county	קאונטי
iofan	איופאן
malko	מאלקו
glenn	גלין
mamoru	מאמורו
abadan	עבדאן
nader	ניידר
prati	פראטי
malaysia	מאלייז'א
gassid	גאסיד
hamoud	חמוד
monterrey	מונטיריי
vienna	ויינא
song	סונג
tong	טונג
wong	וונג
long	לונג
gerty	גרטי
yossi	יוסי
mahmudi	מחמודי
gamil	גמיל
hagen	האגן
blatter	בלאטר
bihar	ביחאר
pezzey	פיזיי
marshall	מארשאל
samaha	סמאחה
andresen	אנדרסן
moradi	מוראדי
linz	לינז
waleed	וליד
rothschild	רותשילד
neira	ניירא
rubinstein	רובינסטין
mccann	מקאן
marmaduke	מארמאדוק
renzo	רינזו
gavras	גאבראס
timbuktu	טימבקטו
ravousis	ראבוסיס
gaarder	גארדר
muriel	מוריאל
olsson	אולסן
montessori	מונטיסורי
dickov	דיקוב
lola	לולא
nordisk	נורדיסק
cemal	ג'מאל
euterpe	יוטירפי
pistone	פיסטוני
roni	רוני
johnny	ג'וני
glen	גלן
gold	גולד
wole	וול
hathairattanakool	האתאיראטאנאקול
oday	עודאי
zengin	זינגן
ribot	ריבו
acutifolia	אקיוטיפוליא
timbaland	טמבלנד
bader	באדר
hiden	הידן
hideo	הידיו
henze	הינז
hammadi	חמאדי
borobudur	בורובודור
chislenko	צ'יסלנקו
palermo	פאלרמו
okamoto	אוקאמוטו
spam	ספאם
hulusi	חולוסי
cinderella	סינדרילא
balaban	באלאבאן
galimzyan	גאלימזיאן
stuart	סטיוארט
menshevik	מנשביק
white	ואיט
cabot	קאבוט
sinan	סינאן
sinai	סאינאי
klasnic	קלאסניטש
rinat	רינת
toriumi	טוריומי
mattias	מאטיאס
nyquist	נאיקסט
piaf	פיאף
simoes	סימוז
lipstadt	ליפסטדאט
alegre	אליגרי
borges	בורכיס
dempsey	דמפסי
maric	מאריק
ozil	אוזיל
souleymane	סולימאן
mingyi	מינגי
rouani	רואני
billel	בילל
campos	קאמפוס
kallon	קאלון
timoshenko	טימושינקו
manuela	מאנואלא
umm	אום
kiwus	קיווס
raducioiu	ראדוסיו
chavez	צ'אביז
taim	טאים
haim	חיים
dardenne	דארדין
lezion	לזיון
đorđevic	דורדיביטש
napoleon	נאפליון
beernaert	בירנארט
haase	האסי
hulk	הלק
rotson	רוטסון
mitnick	מיטניק
takanori	טאקאנורי
kaku	קאקו
takamori	טאקאמורי
benedictine	בינידיקטין
baku	באקו
ripley	ריפלי
piturat	פיטוראט
si	סאי
baba	באבא
yakov	יעקב
palin	פאלין
antonino	אנטונינו
guido	גוידו
morin	מורין
hiele	הילי
klaus	קלאוס
gabor	גאבור
karroubi	קארובי
rivoli	ריבולי
oregon	אוריגון
york	יורק
jorge	ג'ורג'
vasily	ואסילי
sadra	סדרא
percy	פירסי
ron	רון
coty	קוטי
cornelia	קורניליא
ciesla	סיסלא
castano	קאסטאנו
budyanskiy	בודיאניסקי
cornell	קורניל
helt	הילט
halldor	האלדור
puskas	פוסקאס
amos	עמוס
minar	מינאר
zoco	זוקו
donadoni	דונאדוני
chidiac	שידיאק
mizuno	מיזונו
barghouti	ברגותי
daughtry	דוטרי
mandriva	מאנדריבא
masi	מאסי
calexico	קאליקסיקו
alvin	אלווין
nezami	נזאמי
loco	לוקו
davis	דייויס
kiryat	קרית
djalma	ג'אלמא
coco	קוקו
vishnu	וישנו
gustav	גוסטאב
stacy	סטייסי
shatskikh	שאצקיך
sampson	סאמפסון
diaz	דיאז
krishna	קרישנא
nakao	נאקאו
siegfried	סיגפריד
chiba	צ'יבא
ghulam	גולאם
buchholz	בוכהולץ
ars	ארס
mahdoufi	מחתופי
qassem	קאסם
kinan	קנאן
thor	תור
fode	פוד
corelli	קורילי
regensburg	ריגנסברג
beadle	בידל
milka	מילקא
streisand	סטראיסאנד
khashoggi	חאשוגי
christian	קריסטיאן
haßler	האסלר
volterra	בולטירא
camilo	קאמילו
jovian	ג'וביאן
marcell	מארסיל
gorani	גוראני
matsukaze	מאטסקאזי
zapatero	זאפאטירו
sadi	סעדי
cruz	קרוז
nobuyuki	נובויוקי
kozma	קוזמא
benyamin	בנימין
matsuzawa	מאטסוזאוא
fadi	פאדי
joey	ג'וי
arta	ארטא
hampton	האמפטון
norio	נוריו
grimaldi	גרימאלדי
fischler	פישלר
rifaat	ריפעט
qumran	קומראן
elvis	אלביס
ashrawi	עשראוי
breslin	ברסלין
pasanski	פאסאנסקי
trochowski	טרוקווסקי
robredo	רוברידו
breton	בריטון
europe	יורופ
sekularac	סיקולאראק
berlioz	בירליוז
khidiyatullin	חידיאטולין
kurtz	קורטז
israels	איזרילז
hanover	האנובר
istvan	איסטבאן
gazzaniga	גאזאניגא
claus	קלאוס
sofia	סופיא
rossi	רוסי
ricin	ריסין
downing	דאונינג
bannatyne	באנאטין
love	לוב
correa	קוריא
dorin	דורין
halil	הליל
matsukata	מאטסוקאטא
curzon	קורזון
sandor	סאנדור
kempff	קימפף
doris	דוריס
tiraspol	טיראספול
perusic	פירוסיטש
atef	עאטף
berossus	בירוסוס
lansana	לאנסאנא
khaldun	חלדון
stephanopoulos	סטיפאנופולוס
hamilton	האמילטון
coria	קוריא
sanu	סנוע
corin	קורין
domenico	דומיניקו
kristin	קריסטין
manu	מאנו
jacinto	ג'אסינטו
iran	איראן
batroun	בטרון
thucydides	תוקידידיז
leslie	ליסלי
chynna	שינא
fran	פראן
mosab	מוסעב
dimoschaki	דימושאקי
lyonnais	ליונה
mobley	מובלי
ehud	אהוד
nagaland	נאגאלאנד
blazek	בלאזיק
portland	פורטלאנד
nighy	נאי
murayama	מוראיאמא
nikolai	ניקולאי
titano	טיטאנו
kabila	קאבילא
eritrea	אריטריא
louis	לויס
lazarus	לאזארוס
santamarina	סאנטאמארינא
arana	אראנא
sherlock	שרלוק
bollettieri	בוליטיירי
tauno	טאונו
neot	ניות
marlene	מארלין
yunlong	יונלונג
schefer	שפר
yo‘ldosh	יולדוש
fidel	פידל
petros	פטרוס
thonglao	תונגלאו
zamfir	זאמפיר
kouis	קויס
lavi	לביא
bossis	בוסיס
jenas	ג'ינאס
igarashi	איגאראשי
babayaro	באבאיארו
morandi	מוראנדי
croatia	קרויישה
mauriac	מוריאק
poland	פולנד
saleem	סלים
reagan	רייגן
childeric	צ'ילדיריק
rebecca	רביקא
frankie	פראנקי
shuichi	שויטשי
mati	מאטי
athos	אתוס
badou	באדו
grand	גראנד
dati	דאטי
zebec	זיביטש
trotsky	טרוטסקי
suksomkit	סוקסומקיט
rats	ראטס
bandaranaike	באנדאראנאיקה
nigel	נאיג'ל
grant	גראנט
mats	מאטס
frank	פראנק
olympic	אולימפיק
yehud	יהוד
mahamadou	מחמדו
marmaris	מארמאריס
korekiyo	קוריקיו
marcelo	מארטצ'לו
abdallah	עבדאללה
couriol	קוריול
frans	פראנס
boeing	בואינג
hagi	האגי
rodrigo	רודריגו
lenglen	לנגלן
bearzot	בירזוט
nagi	נאגי
konosuke	קונוסוקה
mchugh	מיקהיו
lou	לו
nou	נו
calgary	קאלגארי
vlcek	ולצ'ק
redknapp	רידנאפ
hundertwasser	הונדרטוואסר
ozer	עוזייר
eisner	אייזנר
anghel	אנגיל
gundam	גאנדאם
aractingi	ערקטינגי
daham	דהאם
kiefer	קיפר
ivri	איברי
jack	ג'ק
bangladesh	בנגלאדש
stradivarius	סטראדיבאריוס
benes	בנס
paterson	פאטרסון
dramani	דראמאני
voller	בולר
hashi	האשי
pnina	פנינה
marques	מארקיס
tassotti	טאסוטי
marcus	מארקוס
ade	עאד
carrel	קאריל
liverani	ליוויראני
barcelata	בארסילאטא
macala	מאצ'אלא
aurel	אורל
kudrow	קודרו
gottlieb	גוטליב
whittle	ויטל
richardson	ריצ'ארדסון
noreena	נורינא
weian	ויאן
marbrook	מרברוק
jassim	ג'אסים
crispus	קריספוס
mccormick	מאקורמיק
nelson	נלסון
boru	בורו
mena	מנא
ryder	ראידר
filo	פאילו
pocahontas	פוקאהונטאס
haydn	האידן
morihiro	מוריהירו
nandor	נאנדור
snyder	סנאידר
sefrioui	ספריוי
leopardi	ליופארדי
anatol	אנאטול
portoghesi	פורטוגסי
persie	פירסי
chapman	צ'אפמאן
helmholtz	הלמהולץ
tomou	טומו
boloni	בולוני
nishikawa	נישיקאוא
kosovo	קוסובו
bergmann	ברגמאן
lermontov	לרמנטוב
codjia	קודג'א
stroessner	סטרוסנר
verkerk	וירקירק
weiss	ואיס
waseige	ואסיג'
stekelenburg	סטיקלנבירג
nassim	נאסים
zyklon	זיקלון
compaore	קומפאורי
puyol	פויול
bernanke	בירנאנקי
peter	פיטר
rasmus	ראסמוס
mweene	מויני
alghifari	אלגיפארי
barakat	ברקאט
kibaki	קיבאקי
safafa	ספאפא
voordeckers	וורדיקרז
holon	חולון
ustase	יוסטאס
sudbury	סודברי
wojcik	וויצק
zahorski	זאהורסקי
paz	פאז
raz	ראז
ramy	ראמי
baikonur	באיקונור
darcis	דארסיס
hitzlsperger	היטסלפירגר
chloramphenicol	קלוראמפיניקול
ishihara	אישיהארא
lamy	לאמי
aziz	עזיז
teugels	טיגילס
lemmouchia	לימוטשיא
terry	טירי
kaori	קאורי
anka	אנקא
tzvetan	צביטאן
shamir	שמיר
braizat	בראיזאט
lazare	לאזאר
tatyana	טאטיאנא
guyana	גויאנא
sienna	סיאנא
brno	ברנו
stephan	סטיפאן
bahr	בחר
berezutski	ברזוצקי
amel	עאמל
klug	קלוג
ruy	רוי
katherine	קאתרין
szulik	סזוליק
domitian	דומיטיאן
krzynowek	קרזינוויק
inonu	אינונו
bassam	בסאם
multatuli	מולטאטולי
armia	ארמיא
buy	באי
bassim	באסים
brosnan	ברוסנאן
jahangir	ג'האנגיר
paola	פאולא
imsaad	אמסאעד
pedersen	פידרסן
jarreau	ג'ארו
ilham	אילהאם
paoli	פאולי
chasseriau	קאסיריו
klinghoffer	קלינגופר
spinoza	ספינוזא
mackinnon	מאקינון
majdi	מג'די
ousmane	עוסמאן
finkelstein	פינקלסטאין
grover	גרובר
ghorban	גורבאן
ruth	רות
soraia	סוראיא
pepin	פפין
morgan	מורגן
grillparzer	גרילפארצר
broderick	ברודריק
stupar	סטופאר
mamadou	מאמאדו
migron	מיגרון
razzano	ראזאנו
moldovan	מולדובאן
jocelyne	ג'וסלין
palmiro	פאלמירו
england	אנגלאנד
alec	אליק
tite	טאיט
larrionda	לאריונדא
lebed	ליביד
mite	מאיט
lushan	לושאן
yazd	יאזד
semyonov	סימיונוב
menderes	מנדיריס
bale	בייל
dale	דייל
gronemeyer	גרונמייר
freddie	פרידי
radu	ראדו
kanchelskis	קאנצ'לסקיס
kalanga	קאלאנגא
price	פראיס
miodrag	מיודראג
fatima	פאטימה
brisbane	בריסביין
badu	בדו
chadid	שדיד
carrie	קירי
washington	ואשינגטן
bradesco	בראדיסקו
foley	פולי
sljivo	סליבו
daouda	דואדא
potok	פוטוק
keigo	קייגו
koeman	קומאן
borneo	בורניו
basho	באשו
kengo	קינגו
miro	מירו
kasonde	קאסונדי
stoichita	סטויקיטא
shelby	שילבי
ciro	צ'ירו
shelly	שלי
rmaich	רמייש
sarpei	סארפיי
simpsons	סימפסונז
nudelman	נודלמאן
abdoh	עבדו
spiropoulos	ספירופולוס
gargula	גארגולא
welsh	וילש
slovak	סלובאק
abdou	עבדו
alaidy	אלעאידי
vujadin	בויאדין
zuberbuhler	זוברבוהלר
battir	בטיר
saifi	סאיפי
konishi	קונישי
hanania	חנאניא
oblast	אובלאסט
simons	סימונז
dawa	דאוה
bayda	ביידא
jacmot	ג'אקמוט
murano	מוראנו
hamdy	חמדי
atlantis	אטלאנטיס
goldman	גולדמאן
shilpa	שילפא
trice	טראיס
zhenyu	ז'יניו
shroot	שרוט
hamdi	חמדי
sebastiano	סיבאסטיאנו
shilla	שילא
javad	ג'אוואד
schweitzer	שוייצר
boland	בולאנד
merieme	מריאם
houllier	הולייה
wiltord	וילטורד
plutarch	פלוטארך
piraeus	פיראוס
bellion	בליון
skalski	סקאלסקי
anna	אנא
bouhired	בוחירד
nurmi	נורמי
united	יונאיטד
maryan	מאריאן
sukristov	סוקריסטוב
zermatt	זרמאט
yunnan	יונאן
spallanzani	ספאלאנזאני
lieberman	ליברמאן
veron	וירון
bryan	בראין
givet	גיביט
paletta	פאליטא
blankenstein	בלאנקינסטאין
katsina	קאטסינא
ploetz	פלוטז
mckimson	מקימסון
cruyff	קרויף
hanssen	האנסן
maarten	מארטן
nokia	נוקיא
nursultan	נורסולטאן
nwankwo	נואנקו
kisho	קישו
kishi	קישי
hanyu	האניו
scholes	סקולז
rie	ריה
yan	יאן
leroy	לירוי
mumtaz	מומטאז
keegan	קיגאן
doherty	דוירטי
hirakawa	היראקאוא
cargill	קארגיל
ridley	רידלי
kolodin	קולודין
boubacar	בובקר
nan	נאן
sofyan	סופיאן
dan	דן
fan	פאן
fradique	פראדיק
tiempo	טיימפו
alexandre	אלקסנדר
alexandra	אלקסנדרא
pollyanna	פוליאנא
hanna	חנא
imola	אימולא
levchenko	ליבצ'נקו
alfida	אלפידא
chen	צ'ן
hartmut	הארטמוט
mengele	מנגלה
rugova	רוגובא
ronald	רונאלד
jefferson	ג'פירסון
tonton	טונטון
rivest	ריבסט
krogh	קרוג
mevo	מיבו
batman	באטמאן
karolos	קארולוס
into	אינטו
stanislaw	סטאניסלו
stanislas	סטאנסילאס
aliyev	עלייב
piola	פיולא
copeland	קופלאנד
kaifu	קאיפו
annabi	ענאבי
denis	דניס
galler	גאלר
decane	דיקאן
yun	יון
mutran	מוטראן
vera	וירא
bosnich	בוסניטש
sorbonne	סורבון
cuevas	קויבאס
mommens	מומנז
summers	סאמרז
cyrillic	סיריליק
tristan	טריסטאן
caselli	קאסילי
tuvalu	טובאלו
leonov	ליונוב
senamuang	סינאמואנג
suriname	סורינאם
alaskan	אלסקאן
kaifeng	קאיפנג
benin	בנין
dimitris	דימיטריס
reinders	ריינדירס
lenz	לינז
benz	בנז
megabyte	מיגאבאיט
janssen	ג'אנסן
stefanson	סטפאנסון
yang	יאנג
zeno	זינו
kwame	קואמי
andronicus	אנדרוניקוס
celso	סילסו
amioun	אמיון
octane	אוקטאן
uri	יורי
bseiso	בסייסו
takayoshi	טאקאיושי
xtra	אקסטרא
matyas	מאטיאס
fakroun	פקרון
sarioglu	סאריוגלו
chehab	שהאב
rudd	רוד
jorquera	חורקיירא
bisha	בישה
primorsko	פרימורסקו
andrei	אנדריי
vryzas	וריזאס
miranda	מיראנדא
lestrade	ליסטראד
kandinsky	קאנדינסקי
balde	באלדי
rosenthal	רוזנטאל
harlow	הארלו
bermuda	ברמודא
lombroso	לומברוסו
ganges	גאנג'ז
baligh	באליג
skelton	סקלטון
turki	טורקי
okello	אוקילו
sertic	סירטיטש
schumacher	שומאכר
fenin	פינין
hanns	האנס
darom	דארום
kiatisuk	קאיטיסוק
plessis	פליסיס
hanni	האני
moussa	מוסא
motoyama	מוטויאמא
diba	דיבא
bucaille	בוקאי
sedik	סדיק
sidi	סידי
jacobs	ג'ייקובס
anabta	ענאבטא
mullis	מוליס
mahabharata	מהאבהאראטא
mayakovsky	מאיאקובסקי
dennis	דניס
sahnoun	סחנון
manhattan	מאנהאטן
dirk	דירק
mozart	מוצארט
chiklis	צ'יקליס
travis	טראביס
estrada	אסטראדא
chorda	צ'ורדא
ebeid	עבייד
gassama	גאסאמא
dalmat	דאלמאט
curci	קורסי
huston	היוסטן
raikkonen	ראיקונן
voronin	בורונין
carrasco	קאראסקו
nour	נור
bennis	בניס
danna	דאנא
orson	אורסון
kahlo	קאהלו
crick	קריק
aldo	אלדו
woodville	וודביל
evrytania	אבריטאניא
neeson	ניסון
canna	קאנא
kaiserslautern	קאיזרסלאוטרן
film	פילם
viola	ויולא
progeria	פרוגיריא
dov	דוב
trossero	טרוסירו
bayrou	באירו
trafalgar	טראפאלגאר
brodsky	ברודסקי
karl	קארל
dinu	דינו
schopenhauer	שופנהאור
wuttke	ווטקה
banderas	באנדיראס
drnovsek	דרנובסיק
kanno	קאנו
konstantinos	קונסטאנטינוס
masharawi	משהראוי
memphis	ממפיס
modric	מודריטש
douala	דואלא
olympiad	אולימפיאד
hargreaves	הארגריבז
hubei	הוביי
shabani	שאבאני
moravia	מוראביא
knowles	נוולז
syamsul	סיאמסול
mamiko	מאמיקו
battiston	באטיסטון
russel	ראסל
gary	גארי
nitra	ניטרא
mond	מונד
rex	רקס
cyril	סיריל
tex	טיקס
sisto	סיסטו
ellison	אליסון
ghraib	גרייב
yashin	יאשין
medellin	מידילין
lacour	לאקור
kulthum	קלתום
mctiernan	מקטירנאן
mordechai	מורדכי
soderbergh	סודרבירג
wilders	וילדרז
tchangai	טצ'אנגאי
herzog	הרצוג
risto	ריסטו
givi	גיבי
mikey	מאיקי
murtaz	מורטאז
nordahl	נורדאל
mcgraw	מאקגראו
tasmania	טאזמייניא
treg	טריג
hillel	הילל
ryan	ראיאן
sputnik	ספוטניק
thiago	תיאגו
justin	ג'אסטן
semmeling	סמילינג
hittin	חיטין
greg	גריג
mnari	מנארי
comaneci	קומאנצ'י
yuriy	יורי
sutee	סוטי
nussimbaum	נוסימבאום
toriyama	טוריאמא
schon	סטשון
massimo	מאסימו
lublin	לובלין
lehmann	ליהמאן
zenden	זינדן
tounsi	טונסי
saito	סאיטו
desmond	דיסמונד
carducci	קארדוצ'י
ponedelnik	פונידילניק
stevens	סטיבנס
klinsmann	קלינסמאן
schmidhuber	שמاדהובר
gregor	גריגור
nikolaou	ניקולאו
morozov	מורוזוב
tamra	טאמרא
arca	ארקא
kwadwo	קואדוו
yamazaki	יאמאזאקי
jujiro	ג'וג'ירו
danni	דאני
gigi	ג'יג'י
nene	ניני
pad	פאד
bene	בני
obeid	עובייד
mosteghanemi	מוסטגאנמי
defoe	דיפו
frei	פריי
danny	דאני
bartoli	בארטולי
dunn	דאן
teimuraz	טאימוראז
krajicek	קראיטשק
bad	בד
mounir	מוניר
irene	אירין
ardiles	ארדיליס
mulan	מולאן
senturk	סנטורק
hick	היק
firmani	פירמאני
sharansky	שאראנסקי
mommu	מומו
rohr	רוהר
gallas	גאלאס
merida	מירידא
barrancos	באראנקוס
elytis	אליטיס
junnin	ג'ונין
lohr	לוהר
bachir	בשיר
gorniak	גורניאק
asaf	עסאף
nelo	נילו
kaplychnyi	קאפליצ'ני
schiff	שיף
kertesz	קירטיז
bigogno	ביגוניו
vilnai	וילנאי
guglielmo	גוגלילמו
kingson	קינגסון
jaroslav	יארוסלאב
bonera	בונירא
kaufman	קאופמאן
bidouane	בדואן
arbid	ערביד
charalambos	צ'אראלאמבוס
scalia	סקאליא
menchu	מנצ'ו
arbil	ארביל
ferrara	פירארא
sawt	סאוט
jordi	יורדי
brammertz	בראמירץ
ontario	אונטייריו
niko	ניקו
qosimov	קוסימוב
kakonje	קאקונג'י
russo	רוסו
zurawski	זוראוסקי
latoundji	לאטונג'י
piano	פיאנו
passarella	פאסארילא
khalaf	חלף
mouloud	מולוד
cynthia	סינתיא
barbra	בארברא
burd	בורד
piccinino	פיטשינינו
dublin	דבלין
austin	אוסטין
gillespie	גיליספי
bahja	בהג'א
diarra	דיארא
matejovsky	מאטיובסקי
naotake	נאוטאקי
hiranuma	היראנומא
gryzlov	גריזלוב
fanny	פאני
megalith	מיגלית
legia	ליגיא
schrijvers	שריברז
falkenmayer	פאלקינמאיר
mstislav	מסטיסלאב
knepper	נפר
severino	סיבירינו
ayrton	אירטון
atwood	אטווד
zweig	צבאיג
ammonium	אמוניום
yoav	יואב
buber	בובר
liz	ליז
sfumato	ספומאטו
mcavoy	מקאבוי
lovett	לוביט
c.	ק.
benetti	בניטי
gutzkow	גוטסקוב
toshihide	טושיהידה
brunel	ברוניל
hulagu	הולאגו
tonegawa	טוניגאוא
ortega	אורטיגא
chinghiz	צ'נגיז
adygea	אדיגיא
horatio	הוריישיו
aguero	אגוירו
shkoder	שקודר
patrick	פאטריק
villette	ויליט
christiaan	קריסטיאן
afia	עאפיה
qubad	קובאד
nottingham	נוטינגהאם
jeff	ג'ף
kepler	קפלר
santillana	סאנטילאנה
tracy	טרייסי
hosny	חוסני
jupp	יופ
hosseini	חוסייני
category	קטגורי
saakashvili	סאקאשבילי
barbosa	בארבוסא
suan	סואן
hosni	חוסני
joop	ג'ופ
juan	חואן
kuan	קואן
samba	סאמבא
delaware	דלאוור
pasco	פאסקו
borlaug	בורלוג
gropius	גרופיוס
yakutsk	יאקוטסק
venturi	וינטורי
orinoco	אורינוקו
anelka	אנילקא
zein	זיין
aconcagua	אקונקאגוא
tenco	טינקו
zahovic	זאהוביטש
beynie	בייני
feyenoord	פיינורד
hamrouche	חמרוש
drake	דרייק
hiroshige	הירושיגה
ustinov	יוסטינוב
croce	קרוצ'י
sultan	סולטאן
nedum	נידום
kaczynski	קאטשינסקי
croci	קרוקי
sychev	סיטשב
reuter	רויטר
modena	מודנה
dramane	דראמאן
bohlin	בוהלין
aslan	אסלאן
shawn	שון
avogadro	אבוגאדרו
tintoretto	טינטוריטו
espirito	אספיריטו
tyumen	טיומין
fischer	פישר
hesselink	היסילינק
brock	ברוק
cortes	קורטיס
bardem	בארדם
sandoval	סאנדובאל
zorro	זורו
castro	קאסטרו
frege	פריגה
kahalani	קהלאני
drazan	דראזן
remi	רימי
saumel	סאומיל
zakariya	זקריא
viani	ויאני
huayna	הואינא
bakkati	בקאטי
viana	ויאנא
grande	גראנד
begin	בגין
issam	עסאם
rochelle	רושיל
shady	שאדי
peloponnese	פילופוניז
todd	טוד
tinian	טיניאן
tiersen	טירסן
muin	מועין
lacuesta	לאקויסטא
wojciech	וויסיטש
schubert	שוברט
shusaku	שוסאקו
turandot	טוראנדוט
valdivia	ואלדיביא
ribery	ריברי
karagounis	קאראגוניס
kutcher	קאטשר
goth	גות
stanishev	סטאנישב
giorgio	ג'ורג'ו
ngatjizeko	נגאטג'זיקו
guirane	גויראני
rizzitelli	ריציטילי
doody	דודי
gibli	גיבלי
rachid	רשיד
pascual	פאסקואל
liane	ליאן
yasser	יאסר
plaatjies	פלאטג'יס
maxim	מקסים
jawdat	ג'אודאט
casablanca	קאסאבלאנקא
lamar	לאמאר
morris	מוריס
roberts	רוברטס
isilkul	איסילקול
hoeneß	הוניס
mercure	מירקיור
petrosian	פיטרוסיאן
munzinger	מונזינגר
hadchiti	חדשיטי
ndlovu	נדלובו
aljaldaki	אלג'לדאקי
andre	אנדריי
soyinka	סוינקא
majorelle	מאג'וריל
burqa	בורקע
mccracken	מקראקין
jiang	ג'יאנג
jabotinsky	ג'בוטנסקי
borchardt	בורשארדט
molby	מולבי
hieronymus	הירונימוס
tigana	טיגאנא
holden	הולדין
parsons	פארסונס
syed	סייד
omaar	עומר
tushino	טושינו
aleksei	אלקסיי
giraldo	גיראלדו
cambodia	קמבודיא
xin	זין
vasco	ואסקו
nhlapo	נהאלפו
qin	קוין
drulovic	דרולוביטש
simukonda	סימוקונדא
win	וין
combat	קמבאט
laszlo	לאסזלו
lin	לין
strack	סטראק
haqqi	חקי
shield	שילד
veronicas	ורוניקאז
humberto	הומבירטו
braila	בראילא
kerkouane	קרקואן
spen	ספין
volta	וולטא
finger	פינגר
abigail	אביגייל
mourid	מוריד
apichet	אפיצ'ט
mourad	מוראד
kazuki	קאזוקי
berthod	בירתוד
polat	פולאט
mishima	מישימא
said	סעיד
santangelo	סאנטאנג'לו
netzer	נצר
kubar	קובאר
shefer	שפר
diane	דיאן
yerevan	יריבאן
romero	רומירו
poussin	פוסן
nicolaus	ניקולוס
caldera	קאלדירא
hayam	היאם
moby	מובי
wesam	ווסאם
taft	טאפט
albanna	אלבנא
lossemy	לוסימי
treviso	טריביסו
hussam	חוסאם
papon	פאפון
shikibu	שיקיבו
judit	ג'ודית
takahiro	טאקאהירו
mustafa	מוסטפא
camilla	קאמילא
gounaris	גונאריס
subaru	סובארו
gilberto	גילברטו
virginie	וירג'יני
motorola	מוטורולא
radice	ראדישי
homocysteine	הומוסיסטין
marilyn	מארילין
vasili	عאסילי
harden	הארדן
kremers	קרימרז
kyle	קאיל
thutmose	טחוטמוס
hedy	הידי
jacquard	ג'אקאר
sherihan	שריהאן
kuffer	קאפר
dahlan	דחלאן
enrico	אנריקו
raschke	ראשקי
pinochet	פינושה
reichs	ריקס
mekawy	מקאוי
pompon	פומפון
lidocaine	לידוקאין
wall	וול
mandola	מאנדולא
hobbes	הובז
hocine	הוסין
mbabane	מבאבאן
redmond	רדמונד
mendelssohn	מנדלסון
nubar	נובאר
kurosawa	קורוסאוא
spanish	ספאניש
raphael	רפאל
kurokawa	קורוקאוא
vassell	ואסיל
suraski	סוראסקי
kremnitz	קרמניץ
sabina	סאבינא
donetsk	דונטסק
imperia	אמפיריא
kayal	קאיאל
baikal	באיקאל
lamartine	לאמארטין
ikea	איקיא
kerviel	קרבייל
marinetti	מאריניטי
seb	סב
harbin	הארבין
berlin	ברלין
qasr	קסר
saidou	סאידו
mazowiecki	מאזויקי
spike	ספאיק
vivien	ויויאן
wendy	ונדי
apulia	אפוליא
istanbul	איסטנבול
macfadyen	מאקפאדין
harel	הראל
roderick	רודריק
assad	אסד
gard	גארד
declan	דקלן
transylvania	טראנסילוואניא
dimethyl	דימיתיל
tresor	טריסור
toure	טורה
clovis	קלוביס
shiraishi	שיראישי
morten	מורטן
romario	רומאריו
alexandru	אלקסנדרו
kyi	קי
colbert	קולברט
mjallby	מג'אלבי
jia	ג'יא
kyrastas	קיראסטאס
lia	ליא
azouz	עזוז
notting	נוטינג
mansour	מנסור
bessemer	בסימר
taryn	טארין
mendy	מנדי
kentaro	קינטארו
tourani	טוראני
knight	נאיט
christine	קריסטין
fatmir	פאטמיר
canning	קאנינג
tamas	טמאס
enfield	אנפילד
pentecost	פנטיקוסט
rosalynn	רוזאלין
audin	אודן
maureen	מורין
marek	מאריק
lendl	לינדל
holiday	הולידאי
laursen	לאורסן
assia	אסיא
montague	מונטאגיו
cannavaro	קאנאבארו
madhya	מאדהיא
alali	אלעלי
souleymanou	סוליימאנו
zeller	זלר
warsaw	וארסו
guerrero	גורירו
muntyan	מונטיאן
colvin	קולווין
dayan	דיין
bilady	בילאדי
kapadze	קאפאדזה
ismet	עיסמט
pierre	פיאר
christou	קריסטו
pires	פיריז
gilbert	גילברט
mariusz	מאריוס
wladyslaw	ואדיסואב
ramaz	ראמאז
riyad	ריאד
arghun	ארגון
karel	קאריל
naelson	ניילסון
polynesia	פוליניזיא
pierce	פירס
hadjaoui	חג'אוי
tartu	טארטו
vukcevic	ווקסיביטש
kaloyev	קאלוייב
tauziat	טוזיא
beirut	בירות
avivim	אביבים
timorim	טימורים
jet	ג'ט
cremer	קרימר
akhalkalaki	אכאלקאלאקי
taranto	טאראנטו
jared	ג'אריד
leonidas	ליונידס
hourani	חוראני
sihanouk	סיהאנוק
norton	נורטן
kaplan	קפלאן
hamas	חמאס
havilland	האבילאנד
kuntar	קונטאר
baeza	באיזא
farshad	פרשאד
fanning	פאנינג
anton	אנטון
barka	ברקה
youzhny	יוז'ני
buretsu	בוריטסו
sayako	סאיאקו
grimi	גרימי
farouk	פארוק
rudolph	רודולף
pope	פופ
hidaka	הידאקא
paasilinna	פאסילינא
bushmen	בושמן
bebeto	ביביטו
hope	הופ
yahya	יחיא
komora	קומורא
matsui	מאטסוי
szavay	סאבאי
dixit	דיקסיט
paston	פאסטון
selway	סילויי
debbouze	דבוז
paris	פאריס
rakosi	ראקוסי
elijah	אלאיג'ה
saori	סאורי
hakki	חקי
narey	נארי
floriano	פלוריאנו
tautou	טאטו
mertesacker	מירטסאקר
dee	די
hauer	האויר
oracle	אוראקל
peutinger	פויטינגר
hyang	היאנג
wei	ויי
mikheil	מיכאיל
aristide	אריסטיד
lava	לאבא
stamile	סטאמאיל
rachael	ראיצ'ל
zuma	זומא
gray	גריי
robinsons	רובינסונז
galland	גאלאנד
dalton	דאלטון
sid	סיד
roleder	רולדר
ginsburg	גינסבורג
krankl	קראנקל
yulianto	יוליאנטו
fahrni	פארני
heenan	הינאן
truth	טרות
lutfi	לוטפי
an	אן
prescott	פריסקוט
pruzzo	פרוצו
devilder	דיבאילדר
kamal	קמאל
carew	קארו
andrew	אנדרו
umbria	אומבריא
vermaelen	ורמיילן
seiji	סייג'י
sotirios	סוטיריוס
goldstein	גולדסטין
benito	ביניטו
mitchell	מיטשל
hafez	חאפז
baldry	באלדרי
sadok	סאדוק
reija	ריכא
federline	פידרלאין
mongke	מונקי
shirin	שירין
kranjcar	קראניקאר
nouri	נורי
marti	מארטי
migliore	מיגליורי
vern	וירן
chambers	שאמבירס
radon	ריידון
dustin	דאסטין
radoi	ראדוי
vistula	ויסטולא
blumenthal	בלומנתאל
bouraoui	בוראוי
abedi	עבידי
estadio	אסטאדיו
guantanamo	גואנטאנאמו
ascii	אסקי
bogart	בוגארט
haber	האבר
sipos	סיפוס
ata	עטא
nnamdi	נאמדי
mannheim	מאנהאים
nehru	נהרו
rakhsh	ראכש
genda	גנדא
nikolic	ניקוליטש
aumann	אומאן
hercules	הירקיוליז
schultz	שולטז
akayev	אקאייב
vierne	וירן
knezevic	ניזיביטש
ziryab	זיריאב
plautz	פלאוץ
rabie	רביע
vucinic	בוסיניטש
leone	ליון
rabia	רביע
fendi	פינדי
khoury	חורי
lew	לו
sodium	סודיום
auguste	אוגסט
kenta	קינטא
netto	ניטו
moliere	מולייר
zaimoglu	זאימוגלו
mirel	מירל
mirek	מיריק
hollerith	הולירית
novotna	נובוטנא
roentgenium	רונטגניום
salmeen	סאלמין
peruggia	פירוגיה
simas	סימאס
sizemore	סאיזמור
dniester	דניסטר
sahel	סאחל
galakos	גאלאקוס
palatinate	פאלאטינייט
pausini	פאוזיני
holmes	הולמז
venter	וינטר
pastrana	פאסטראנא
polanski	פולאנסקי
zoran	זוראן
golan	גולן
meller	מילר
sucralose	סוקרלוס
carey	קארי
habib	חביב
gustaf	גוסטאף
raldes	ראלדיס
rose	רוז
mitsumune	מיטסומוני
kwon	קוון
bormann	בורמאן
pinel	פיניל
turgut	טורגוט
schussel	שוסל
sakichi	סאקיצ'י
nasdaq	נאסדאק
sondergaard	סונדרגארד
oldham	אולדהאם
hanks	האנקס
virginia	וירג'יניא
aki	אקי
rafah	רפח
starck	סטארק
surgut	סורגוט
dindane	דנדאני
traoui	טראוי
jaspers	יאספרז
rubik	רוביק
gokhan	גוכאן
betta	ביטא
connors	קונרז
roxburgh	רוקסבורג
kanafani	קנפאני
bobby	בובי
keiji	קייג'י
rajavi	רג'אבי
afrikaner	אפריקאנר
masudi	מאסודי
salibi	סליבי
ashkelon	אשקלון
alfarazdaq	אלפרזדק
irbid	אירביד
shiro	שירו
klan	קלאן
kerimov	קרימוב
jesper	יספר
wheater	ויטיר
feiler	פיילר
finkielkraut	פינקילקרוט
kasraoui	קסראוי
okazaki	אוקאזאקי
joshua	ג'ושוא
ivanhoe	איבאנהו
carlos	קארלוס
bregerie	בריגירי
haminu	האמינו
maamar	מועמר
bilbao	בילבאו
baltaah	בלטעה
mubarak	מובארק
gobbi	גובי
bantustan	באנטוסטאן
milosz	מילוש
senaki	סינאקי
julius	ג'וליוס
shahak	שחק
melvil	מלביל
papa	פאפא
shafiq	שפיק
debbagh	דבאג
kabil	קאביל
avril	אבריל
spector	ספקטור
brendan	ברנדאן
reymont	ריימונט
capa	קאפא
sestic	ססטיק
unit	יוניט
bijeljina	ביילינא
brennan	ברינאן
anomer	אנומר
vanoni	ואנוני
ofakim	אופקים
halimi	חלימי
shunsuke	שונסוקי
stevenson	סטיבנסון
federer	פדרר
jerkovic	ירקוביטש
thrace	תרייס
hugues	הוגיז
dolph	דולף
spanic	ספאניק
aritomo	אריטומו
torah	תורה
niigaki	ניגאקי
zenga	זנגא
balaton	באלאטון
landau	לאנדאו
daimler	דיימלר
nobunaga	נובונאגא
zahir	זאהיר
vyshnevskyi	וישנבסקי
solaris	סולאריס
henry	הנרי
aleksander	אלקסנדר
kunitsyn	קוניטסין
pierluigi	פיירלויג'י
almaszadeh	אלמאסזאדה
pattaya	פאטאיא
mladic	מלאדיטש
zana	זאנא
nikolaev	ניקולאייב
cornthwaite	קורנתויט
kawai	קאואי
damanakis	דאמאנאקיס
sidon	סידון
laver	לאבר
logie	לוגי
siddiq	סדיק
rep	רפ
nabil	נביל
menichelli	מניקילי
magdi	מגדי
vladikavkaz	ולאדיקאבקאז
mashhad	משהד
leo	ליאו
mammeri	מעמרי
mathijsen	מאתיסן
zaidan	זאידן
junayd	ג'ונייד
hopkins	הופקינס
ludwig	לודביג
sammy	סאמי
sibiu	סיביו
numidia	נומידיא
cortisol	קורטיזול
guderian	גודיריאן
fred	פריד
rinaldo	רינאלדו
ziege	זיגה
booy	בוי
pearl	פירל
ibn	איבן
kanther	קאנתר
sokolow	סוקולוב
osvaldo	אוסבאלדו
hrbaty	הרבאטי
miliband	מיליבאנד
wozniacki	בוזניאקי
tardelli	טארדילי
perlmutter	פירלמוטר
katip	קאטיפ
bohm	בום
mashal	משעל
oldfield	אולדפילד
lagos	לאגוס
nimar	נימר
ouertani	ורטאני
bahjat	בהג'ט
shapley	שייפלי
sabbatai	שבתאי
magalhaes	מאגאלהאיז
macau	מאקאו
zanzibar	זנזיבאר
india	אינדיא
saganowski	סאגאנווסקי
toto	טוטו
costanza	קוסטאנזא
aoun	עאון
yohan	יוהאן
noto	נוטו
adivasi	אדיבאסי
shalmaneser	שלמנסר
yukichi	יוקיצ'י
delvecchio	דלביקיו
myanmar	מיאנמאר
goto	גוטו
brendell	ברינדל
hananu	הנאנו
moran	מוראן
mihail	מיהאיל
elgamal	אלגמל
muzinic	מוזיניטש
nikki	ניקי
hawthorne	האותורן
maldonado	מאלדונאדו
haraam	חראם
puerta	פוארטא
zell	זיל
rhee	רי
hebert	היבירט
glotov	גלוטוב
claude	קלוד
kazuya	קאזויא
fekri	פקרי
constantinescu	קונסטאנטינסקו
banks	באנקס
tori	טורי
cools	קולז
bell	בל
armando	ארמאנדו
rasa	ראסא
bernal	ברנאל
manouchehr	מנוצ'הר
hayatou	חיאטו
sivok	סיבוק
lascelles	לאסילס
dori	דורי
gaston	גאסטון
calum	קאלום
baher	באהר
bent	בנט
cent	סנט
tserkva	טסירקבא
demerit	דימיריט
shabab	שבאב
chaidari	חאידארי
sampaio	סאמפאיו
dimona	דימונה
heche	הש
ilya	איליא
dehn	דהן
fehn	פיהן
volodymyr	וולודימיר
meeno	מינו
silwan	סילואן
kristensen	קריסטנסן
nikita	ניקיטא
chicago	שיקאגו
alta	אלטא
steinbeck	סטיינבק
nepal	נפאל
scorsese	סקורסיזי
souad	סועאד
mcbride	מקבראיד
shiller	שילר
uganda	אוגאנדא
winona	וינונא
lobodzinski	לובודזינסקי
kopke	קופקה
tocantins	טוקאנטינז
muti	מוטי
grandes	גראנדס
silvestre	סילביסטר
schneiderhan	שנאידרהאן
svetoslav	סביטוסלאב
bass	באס
boateng	בוטינג
pious	פאיוס
mile	מיל
frances	פראנסס
keene	קין
teymourian	טיימוריאן
yahalom	יהלום
fahed	פאהד
pellegrini	פיליגריני
miguel	מיגל
kinkel	קינקל
klose	קלוס
fortuny	פורטוני
pond	פונד
petr	פיטר
lausanne	לוזאן
sousa	סוזא
durs	דורס
greenspan	גרינספאן
bikila	ביקילא
mosley	מוזלי
iba	איבא
pantelic	פאנטיליטש
zohar	זוהר
bremner	ברימנר
pryor	פראיור
nasrallah	נסראללה
todorov	טודורוב
sidhom	סידהום
tamoxifen	טאמוקסיפין
sussmuth	סוסמות
sholes	שולז
bandeira	באנדירא
vale	וייל
galili	גלילי
metallica	מיטאליקא
hatsumi	האטסומי
finland	פינלאנד
koken	קוקן
thabo	תאבו
sneh	סנה
connery	קונרי
cronbach	קרונבאך
hirsi	הירסי
timmy	טימי
darren	דארין
roseau	רוסו
shabtai	שבתאי
nisr	ניסר
alberti	אלברטי
margaret	מארגריט
coras	קוראס
smertin	סמירטין
lauridsen	לאורידסן
stapleton	סטייפלטון
yasuda	יאסודא
jeremie	ג'רמי
rehman	רחמאן
cecilia	סיסיליא
nimitz	נימיץ
mechner	מקנר
topolanek	טופולאניק
golanski	גולאנסקי
mitic	מיטיטש
delphi	דילפי
mladen	מלאדן
thuram	טוראם
berisha	בארישא
gariseb	גאריסב
delilah	דלאילה
maidin	מאידן
nunavut	נונאבוט
shinoda	שינודה
qvist	קביסט
beer	ביר
sanders	סאנדרז
daoud	דאוד
reynald	רינאלד
proyas	פרויאס
smithies	סמיתיז
shola	שולא
elghitani	אלגיטאני
colleen	קולין
knez	ניז
vava	ואוא
babangida	באבנגידא
tagoe	טאגו
pedro	פדרו
antigua	אנטיגוא
lada	לאדא
vukojevic	בוקוביטש
micah	מיקה
umaru	עמארו
mozambique	מוזאמביק
tico	טיקו
vitalis	ויטאליס
goran	גוראן
meeuws	מיוס
hanoune	חנון
brahe	בראהי
parc	פארק
jules	ז'ול
aliaksandr	אליאקסאנדר
lorenz	לורנז
norodom	נורודום
cardilli	קארדילי
reinhardt	ראינהארט
raymond	ראימונד
barclay	בארקליי
cocis	קוקיס
coxon	קוקסון
markov	מארקוב
ferdinand	פרדינאנד
ruwi	רוי
bliss	בליס
vanaheimr	ואנאהימר
verlaine	ורלן
vercauteren	ורקואטירין
payne	פיין
goda	גודא
chafurin	צ'אפורין
belaid	בילייד
burla	בורלא
hofi	חופי
fridman	פרידמאן
sarhan	סרחאן
massaro	מסארו
lashley	לאשלי
kabul	קאבול
frey	פריי
sloan	סלון
butte	ביוט
ganzouri	גנזורי
quintin	קוינטין
rusk	ראסק
bhatia	באטיא
benicio	ביניסיו
klopp	קלופ
pranjic	פראניטש
marcelino	מארסילינו
strittmatter	סטריטמאטר
ramljak	ראמליאק
zhu	ז'ו
moneo	מוניו
milligan	מיליגאן
sneijder	שנאידר
santoro	סאנטורו
gestapo	גסטאפו
moggi	מודג'י
jerusalem	ג'רוסאלם
mehaidli	מחידלי
gallagher	גאלאגר
gargo	גארגו
nyarko	ניארקו
arazi	ארזי
thoreau	תורו
sugiyama	סוגייאמא
elm	אילם
sanz	סאנז
durkheim	דורקהיים
nostra	נוסטרא
keynes	קינז
litvinov	ליטבינוב
hod	הוד
schroeder	שרודר
giolitti	ג'וליטי
wooddin	וודן
kusumi	קוסומי
mochizuki	מוצ'יזוקי
konev	קוניב
zamorano	זאמוראנו
lenstra	לינסטרא
blanco	בלאנקו
fisher	פישר
samarkand	סמרקנד
romanos	רומאנוס
coriolis	קוריוליס
glutamine	גלוטאמין
pristina	פריסטינא
rosenblum	רוזנבלום
diyarbakr	דיארבקר
norihiro	נוריהירו
radiohead	ראדיוהד
mahmoud	מחמוד
billong	בילונג
dasayev	דאסאייב
jusufi	יוסופי
kingston	קינגסטון
coolidge	קולידג'
lavigne	לאבין
sigrid	סיגריד
adair	אדייר
yoshiro	יושירו
bouab	בועב
blagoja	בלאגויה
donner	דונר
holderlin	הולדרלין
lyman	לימאן
milford	מילפורד
saadane	סעדאן
francisco	פראנסיסקו
fagan	פייגן
cornwall	קורנואל
rossellini	רוסוליני
constantius	קונסטאנטיוס
stelios	סטיליוס
fiasco	פיאסקו
brzic	ברזיטש
clayderman	קליידרמאן
kajiura	קאג'יורא
pascoal	פאסקואל
smolensk	סמולינסק
stif	סטיף
greenwood	גרינווד
geczi	גקזי
andoni	אנדוני
falcao	פאלקאו
callaghan	קאלאגאן
ernest	ארנסט
thaksin	תאקסין
cipolla	צ'יפולא
dickinson	דיקינסון
morphy	מורפי
schmidt	שמידט
viswanathan	ויסואנאתאן
mattawa	מטאוע
laurie	לורי
shamil	שאמיל
bonner	בונר
birsk	בירסק
kaia	קאיא
maia	מאיא
zaki	זקי
atkinson	אטקינסון
allam	עלאם
corneliu	קורניליו
amnon	אמנון
repetto	ריפיטו
roy	רוי
maki	מאקי
henderson	הנדרסון
eshel	אשל
toyotomi	טויוטומי
bulent	בולנט
honda	הונדא
koster	קוסטר
takahata	טאקאהאטא
denzel	דינזל
foly	פולי
jericho	ג'ריקו
suha	סוחה
denzil	דינזל
wayne	ויין
atopic	אטופיק
setsubun	סיטסובון
cosmin	קוזמין
fouad	פואד
yuji	יוג'י
dafoe	דאפו
shengelia	שינגיליא
diouf	דיוף
tamada	טאמאדא
vingada	וינגאדא
bolelli	בולילי
brecht	ברישט
bahnini	בחניני
kantaro	קאנטארו
bosman	בוסמאן
idi	עידי
steed	סטיד
ferrini	פיריני
jody	ג'ודי
baeyer	באיר
keketi	קקיטי
steel	סטיל
foster	פוסטר
zhang	ז'אנג
alnemri	אלנמרי
omari	עומארי
gehry	גירי
lavey	לייבי
allouni	עלוני
cosgrove	קוסגרוב
hobeika	חובייקה
sucha	סושא
kendrick	קנדריק
derwall	דירואל
carmagnola	קארמאנולא
vorilhon	וורילון
traianos	טראיאנוס
naysmith	נייסמית
tevez	טיביז
sanger	סאנגר
seoul	סיאול
pereira	פיריירא
takahashi	טאקאהאשי
majstorovic	מאיסטרוביטש
elst	אלסט
khairy	חיירי
fernandez	פרנאנדיז
mercedes	מרסידס
shigeyoshi	שיגיושי
hutu	הוטו
fernandes	פירנאנדיז
mutu	מוטו
duberry	דוברי
guinness	גיניס
remetter	רימיטיר
asi	עאסי
faurisson	פוריסון
joanna	ג'ואנא
eberhard	אברהארד
horison	הוריסון
boyd	בויד
yul	יול
cocu	קוקו
basinas	באסינאס
junger	ג'ונגר
salameh	סלאמה
sul	סול
gottfried	גוטפריד
elrich	אלריטש
russell	ראסל
taksim	טקסים
euripides	יוריפידיז
lang	לאנג
brahem	בראהם
mettomo	מיטומו
cafu	קאפו
hawsawi	האוסאוי
zakariyya	זקריא
levine	לוין
pierino	פיירינו
henedi	הנידי
saborio	סאבוריו
rogers	רוג'רז
cheadle	צ'ידל
alighieri	אליגיירי
clair	קלייר
shankly	שאנקלי
yefim	יפים
stephens	סטיפנס
thant	תאנט
audrey	אודרי
terim	טירים
junior	ג'וניור
galinovic	גאלינוביטש
witschge	ויטסטשג
huard	הוארד
takashi	טאקאשי
sarandon	סאראנדון
kruzen	קרוזן
tir	טיר
rostislav	רוסטיסלאב
rani	ראני
eindhoven	אנדהובן
pless	פליס
touqan	טוקאן
hirosue	הירוסו
dahlman	דאלמאן
kewell	קיוול
zoubeir	זוביר
nani	נאני
linares	לינאריס
shane	שיין
dani	דאני
nakazawa	נאקאזאוא
rambutan	ראמבוטאן
eddie	אדי
royal	רויאל
hiroaki	הירואקי
rashed	ראשד
palladio	פאלאדיו
santana	סאנטאנא
gohar	גוהר
middleton	מידלטון
poulsen	פולסן
jenei	ג'יניי
rashid	רשיד
toshiro	טושירו
jinyu	ג'יניו
yumi	יומי
welwyn	וילוין
vukotic	ווקוטיטש
waxman	ואקסמאן
emanuel	עמנואל
chagas	שאגאס
toshimichi	טושימיטשי
kumi	קומי
endemol	אנדמול
bartter	בארטר
reinhart	ריינהארט
ernie	ארני
wallach	ואלאך
ciprian	קיפריאן
donovan	דונובאן
fitzgerald	פיצג'ראלד
rasmussen	ראסמוסין
angkor	אנגקור
rashad	רשאד
fangzhuo	פאנגז'ו
lichtsteiner	ליכטסטיינר
pompeii	פומפיי
tom	טום
hyde	האיד
devall	דיבאל
moder	מודר
mboma	מבומא
cesare	סיזר
goumas	גומאס
cervantes	סרבאנטס
russ	רוס
dom	דום
hafeet	חפיט
shorey	שורי
kapsis	קאפסיס
bratt	בראט
altai	אלטאי
raleb	ראלב
alfons	אלפונס
maltese	מאלטיז
balkans	באלקאנז
nowitzki	נוביטסקי
bratz	בראטז
skah	סקאח
roddy	רודי
uk	אוק
horemheb	חורמחב
somerhalder	סומרהאלדר
zvartnots	זבארטנוטס
vargas	וארגאס
milano	מילאנו
kalifa	חליפה
kasper	קאספר
uyghur	ויגור
guillot	גוילוט
seaman	סימאן
renan	רינאן
rudyard	רדיארד
sikorsky	סיקורסקי
bru	ברו
vogel	בוגל
anubis	אנוביס
younis	יונס
kohlschreiber	קולשראיבר
shimon	שמעון
mauricio	מוריסיו
khayachi	כאיאשי
robson	רובסון
brenda	ברינדא
younes	יונס
bobadilla	בובאדילא
benedict	בנדיקט
nicolae	ניקולאי
haitham	האיתם
scaloni	סקאלוני
krim	קרים
bueno	בוינו
diomansy	דיומאנסי
younus	יונוס
zelaya	זילאיא
neves	ניביס
bernini	בירניני
romina	רומינא
kerim	קרים
hussain	חוסיין
hussein	חוסיין
harare	הרארי
sturluson	סטרלסון
becker	בקר
albania	אלבניה
maozhen	מואז'ן
knipper	קניפר
holloway	הולויי
zeljko	זיליקו
roger	רוג'ר
sugihara	סוגיהארא
stefani	סטיפאני
kabongo	קאבונגו
jibril	ג'יבריל
duraid	דורייד
torsten	טורסטן
mclaren	מאקלארין
apolo	אפולו
erato	אראטו
tommaso	טומאסו
vlastimil	ולאסטימיל
marias	מאריאס
nevada	ניבאדא
lisa	ליסא
dragoslav	דראגוסלאב
merk	מירק
caravaggio	קאראבאג'יו
jonas	ג'ונאס
qabbani	קבאני
kirby	קירבי
sabrosa	סאברוסא
piccadilly	פיקאדילי
heaney	היני
illiasu	אליאסו
yar	יאר
fredericks	פרידריקס
douglass	דוגלאס
senjuro	סינג'ורו
pascal	פאסקאל
haider	חידר
meier	מאיר
spalletti	ספאליטי
laguna	לגונה
gomis	גומיס
vitruvius	ויטרוביוס
dar	דאר
etrog	אתרוג
albi	אלבי
arizona	אריזונא
miljan	מיליאן
tate	טייט
garba	גארבא
caspar	קאספאר
popular	פופיולאר
hamaguchi	האמאגוצ'י
hemidi	חמידי
balash	בלאש
dalglish	דאלגליש
edo	אידו
douro	דורו
nouakchott	נואקשוט
hatzor	חצור
enayati	ענאיאטי
grygera	גריגירא
diss	דיס
ruslan	רוסלאן
rudy	רודי
daladier	דלאדייה
mazda	מאזדא
fish	פיש
davidson	דייבידסן
lyndon	לינדון
durban	דורבאן
roudbarian	רודבאריאן
rayyan	ריאן
keri	קירי
saipan	סאיפאן
kinski	קינסקי
domenghini	דומנגיני
szarmach	זארמאך
zaccheroni	זאקירוני
tomokazu	טומוקאזו
boye	בוי
cheikh	שיך
hermon	הרמון
mickey	מיקי
tassos	טאסוס
bracciali	בראשיאלי
herman	הרמאן
solomon	סולומון
riyashi	ריאשי
seles	סיליש
tarkan	טארקאן
placido	פלאסידו
hesse	היסה
gavriil	גאבריל
gershon	גרשון
macapa	מאקאפא
picasso	פיקאסו
ackerman	אקרמאן
conan	קונאן
gaspar	גאספאר
messina	מסינא
maurer	מורר
dekalim	דקלים
romulus	רומיולוס
kazuyoshi	קאזויושי
cub	קאב
tammet	טאמיט
young	יונג
big	ביג
darius	דאריוס
karrer	קארר
badoglio	באדוליו
kris	קריס
forster	פורסטר
montolivo	מונטוליבו
accademia	אקאדימיה
saartjie	סארטג'י
katzir	קציר
diaby	דיאבי
katzer	קאטזר
faruk	פארוק
messi	מסי
rosetti	רוזיטי
broissart	ברויסארט
helen	הלן
amer	עאמר
spitzer	ספיצר
vojacek	בויאצ'ק
heyligen	היליגין
hedman	הדמאן
wunderlich	וונדרליש
kyzyl	קיזיל
hristov	הריסטוב
meynieu	מייניו
kinnock	קינוק
dobson	דובסון
doolittle	דוליטל
chevanton	שיבאנטון
blair	בלייר
selassie	סילאסי
hadith	חדית
nicolo	ניקולו
cantabria	קאנטאבריא
rutherford	רתרפורד
nakayama	נאקאיאמא
goebbels	גובלז
nili	נילי
vyacheslav	ויאצ'יסלאב
thalia	תאליא
gentiana	ג'נטיאנא
aubrey	אוברי
matthieu	מאתיו
pau	פאו
janowski	ג'אנוסקי
paracetamol	פאראסיטאמול
jesse	ג'סי
brul	ברול
meles	מיליס
quesnay	קיניי
mckenna	מאקקינא
weizman	ויצמן
montasser	מונתסר
bau	בו
buzan	בוזאן
ayoun	עיון
bonn	בון
buzau	בוזאו
garics	גאריקס
ramazzotti	ראמאזוטי
guttmann	גוטמאן
davidka	דאבידקא
hidetoshi	הידיטושי
porphyria	פורפיריא
dhyna	דיאנא
koppel	קופל
harpo	הארפו
hatthaporn	האטאפורן
ponzio	פונזיו
gilboa	גלבוע
hahn	האן
darabont	דאראבונט
jahn	יאן
brisson	בריסון
vercoutre	ורקוטר
minambres	מינאמבריס
galahad	גאלאהאד
bukharin	בוכארין
eretria	אריטריא
liakhov	ליאקוב
folke	פולק
guebuza	גויבוזא
regan	ריגן
takanohana	טאקאנוהאנא
liotta	לאיוטא
boc	בוק
mariah	מאריא
messier	מסייה
maeda	מאידא
guzan	גוזאן
celestine	סילסטין
anaheim	אנאהאים
montand	מונטאן
barzani	בארזאני
abduh	עבדוה
indonesia	אינדוניז'א
vytlacil	ויטלאסיל
ayache	עיאש
borland	בורלאנד
urwah	עורוה
heath	הית
thierry	טיירי
bodrum	בודרום
chaeruddin	צ'ארודין
ecuador	אקואדור
jarno	יארנו
friedensreich	פרידנסראיש
wim	וים
mykhaylychenko	מיכאליטשינקו
jawhar	ג'אוהר
giannini	ג'אניני
ravin	ראבין
ford	פורד
meno	מינו
jrme	ג'רם
hiam	היאם
saud	סעוד
kerala	קיראלא
mudingayi	מודינגאי
liam	ליאם
kassab	קסאב
bulykin	בוליקן
maud	מוד
cicinho	סיסינהו
daud	דאוד
belize	בליז
cathcart	קאתקארט
friedrich	פרידריק
martti	מארטי
xanthopoulos	קזאנתופולוס
maezono	מייזונו
madjer	מאג'ר
fontana	פונטאנא
damjanovic	דאמיאנוביטש
frau	פראו
lanese	לאניזי
kyd	קיד
alfonso	אלפונסו
frederic	פרידריק
wittig	ויטיג
cheb	שב
crockett	קרוקיט
taupo	טאופו
srpska	סרפסקא
ferguson	פרגוסון
matthaus	מאטאוס
carlton	קארלטון
coast	קוסט
djourou	דג'ורו
topher	טופר
luczak	לוקזאק
malone	מאלון
kanfory	קאנפורי
curtis	קארטיס
siphandon	סיפאנדון
joel	ג'ול
gangnihessou	גאנגניהיסו
yukiya	יוקיא
wiki	ויקי
kiki	קיקי
miki	מיקי
zurn	זורן
sepp	ספ
hickersberger	היקרסבירגר
ciaran	קיאראן
abhur	אבחור
yoan	יואן
ralston	ראלסטון
felipe	פיליפי
hayley	היילי
shrek	שרק
vladica	ולאדיקא
bah	באה
joan	ג'ון
damme	דאם
crothers	קרותרס
berkeley	בירקלי
gjirokaster	גירוקאסטר
cobi	קובי
denshawai	דנשואי
kaoru	קארו
andreas	אנדריאס
elmaleh	אלמאלח
curtiss	קורטיס
roggeveen	רוגיבין
kafka	קאפקא
venetiaan	ויניטיאן
eiffel	איפל
ratomir	ראטומיר
lansing	לאנסינג
kahane	קאהאנא
zauri	זאורי
radha	ראדהא
modigliani	מודיליאני
ayn	עין
radhi	ראדי
lurie	לורי
rensenbrink	רינסינברינק
butelle	בוטילי
dervite	דרבייט
alia	עליא
satrapi	סאטראפי
armand	ארמאנד
elia	אליא
disney	דיזני
victoriano	ויקטוריאנו
helman	הלמאן
pascani	פאסקאני
leitgeb	ליטגיב
roosevelt	רוזוולט
malivai	מאליבאי
sally	סאלי
deem	דים
zeila	זילע
okwunwanne	אוקוונואני
diawara	דיאוארא
anglia	אנגליא
kienast	קינאסט
tugce	טוג'י
draco	דראקו
mumbai	מומבאי
sesumaga	סיסומאגא
polyene	פוליין
sante	סאנטי
susan	סוזאן
santa	סאנטא
susak	סוסאק
holcer	הולקר
gadish	גאדיש
santo	סאנטו
boulle	בול
hoshi	הושי
chamoun	שאמון
myra	מאירא
heyrovsky	הاירובסקי
bellone	בילוני
bucker	באקר
nellis	ניליס
christiansen	קרישצ'אנסן
tsunayoshi	טסונאיושי
tabucchi	טאבוקי
ting	טינג
gutenberg	גוטנברג
maillart	מאילארט
king	קינג
ling	לינג
ming	מינג
maharashtra	מאהאראשטרא
bing	בינג
anderssen	אנדרסן
locklear	לוקליר
habre	חברי
affleck	אפליק
djelloul	ג'לול
begag	בגאג
kesarev	קיסאריב
tsymbalar	צימבאלאר
dhorasoo	דוראסו
britain	בריטאן
almunia	אלמוניא
silajdzic	סילאידזיטש
bjarni	ביארני
franz	פראנז
halle	הל
fantini	פאנטיני
zaidiyyah	זאידיה
dellas	דילאס
contador	קונטאדור
gentileschi	ג'נטלסקי
majeed	מג'יד
cherry	צ'רי
legend	לג'נד
gudelj	גודילי
moshe	משה
cardinal	קארדינל
kila	קילא
billstrom	בילסטרום
hutchison	האצ'יסון
dupas	דופאס
zozimo	זוזימו
pini	פיני
shwery	שוירי
vivaldi	ויואלדי
rasoul	רסול
clemence	קלימינס
butor	בוטור
tortola	טורטולא
venezuela	ונזוילא
dini	דיני
highmore	האימור
thurman	תורמאן
kallstrom	קאלסטרום
durix	דוריקס
curie	קיורי
alioui	עליוי
garmendia	גארמנדיא
tokugawa	טוקוגאוא
bubnik	בובניק
roeder	רודר
alvarado	אלבאראדו
roux	רו
koshi	קושי
burke	בורק
jonbenet	ג'ונביניט
yukio	יוקיו
amatzia	אמציה
raemon	ראימון
tamboura	טאמבורא
zinta	זינטא
ken	קן
heylens	היילנס
marius	מאריוס
carell	קארל
ben	בן
knighton	נאיטון
carretera	קאראטירא
muzdalifah	מוזדליפה
kurdistan	קורדיסטאן
zuckermann	זאקרמאן
laslandes	לאסלאנד
lamine	לאמאין
rush	ראש
tremoulinas	טרימולינאס
minot	מינוט
slava	סלאבא
sarr	סאר
vikash	ויקאש
herschel	הירשיל
abie	אבי
toomey	טומי
dumbledore	דמבלדור
tosic	טוסיטש
schmolck	שמולק
carr	קאר
tobin	טובין
kusao	קוסאו
kadlec	קאדליץ
dafna	דפנא
liviu	ליביו
francini	פראנשיני
chamot	צ'אמוט
bruhin	ברוהין
kante	קאנטי
gustavo	גוסטאבו
schickard	שיקארד
thomas	טומאס
musso	מוסו
soskic	סוסקיטש
hajduk	האידוק
mervyn	מירבין
mudar	מודאר
kruger	קרוגר
blagoje	בלאגויה
laird	לירד
vlado	ולאדו
hossam	חוסאם
voldemort	וולדמורט
docherty	דוקירטי
kokoschka	קוקושקא
samsun	סאמסון
nissan	ניסאן
guiscard	גיסקארד
najib	נג'יב
salampessy	סאלאמפסי
ivo	איבו
rouissi	רויסי
boral	בוראל
sharif	שריף
samson	סאמסון
jeremy	ג'רמי
iosif	איוסיף
husni	חוסני
nicolai	ניקולאי
bridget	בריג'ט
salhab	סלהב
holt	הולט
kjar	קיאר
london	לונדן
reynaud	רינו
yevgeny	יבגני
carbajal	קארבאכאל
bolt	בולט
colt	קולט
buyten	בויטן
jussi	יוסי
propane	פרופיין
richthofen	רישטהופן
rico	ריקו
ferrari	פירארי
takagi	טאקאגי
sienkiewicz	סינקיביטש
yushchenko	יושצ'נקו
myojin	מיוג'ן
leandro	ליאנדרו
nico	ניקו
bahamas	באהאמאס
fakhri	פכרי
bornstein	בורנסטאין
szeged	זיגיד
view	ויו
hashemian	האשמיאן
indiana	אינדיאנא
estili	אסטילי
photoshop	פוטושופ
dalli	דאלי
constans	קונסטנס
leucine	לוסין
hull	הל
dusan	דוסאן
lulea	לוליא
eugene	יוג'ין
wes	וס
les	לס
ballmer	באלמר
pasqual	פאסקואל
aes	איס
tucci	טוצ'י
johns	ג'ונז
coleman	קולמאן
reuven	ראובן
salah	סלאח
scotty	סקוטי
xucuru	זוקורו
chan	צ'אן
karlheinz	קארלהאינז
kuhn	קון
belmondo	בלמונדו
patience	פיישאנס
krug	קרוג
poincare	פואנקארה
imamura	אימאמורא
reinhold	ראינהולד
ornella	אורנילא
utada	אוטאדא
nir	ניר
kashua	קשוע
wieghorst	ויהורסט
ennio	אניו
gosho	גושו
hampden	האמפדן
giampiero	ג'אמפיירו
merneptah	מרנפטאח
sauvage	סובאג'
lively	לאיבלי
ginaton	גינתון
liza	ליזא
zaur	זאור
pelton	פילטון
piero	פיירו
vojvodina	בויבודינא
gennaro	גנארו
iraq	עיראק
viliam	ויליאם
stade	סטאד
fiqh	פיק
braille	בריاל
shakib	שאקיב
coluna	קולונא
galli	גאלי
goodman	גודמאן
renschler	רנשלר
vilnius	וילניוס
rockwell	רוקוול
galla	גאלא
dimba	דימבא
constable	קונסטאבל
hubble	האבל
shackleton	שאקלטון
sergio	סרג'יו
schiavone	שיאבוני
mills	מילז
ahmad	אחמד
werner	ורנר
mintz	מינץ
bangoura	באנגורא
dimitri	דימיטרי
falla	פאלא
libre	ליבר
sukhoi	סוכוי
taimanov	טאימאנוב
lilly	לילי
lupatelli	לופאטילי
semak	סימאק
ofer	אופר
roudolphe	רודולף
tennant	טינאנט
stone	סטון
mudrik	מודריק
alexandrina	אלקסאנדרינא
fanta	פאנטא
bette	ביט
france	פראנס
hadj	חאג'
stallone	סטאלון
malal	מלאל
roddick	רודיק
cugnot	קוניו
benelux	בנילוקס
leuven	לובין
lockheed	לוקהיד
rand	ראנד
dunam	דונם
toulon	טולון
bubka	בובקא
trenton	טרינטון
bugnet	בוגניט
chikao	צ'יקאו
landry	לאנדרי
schroder	שרודר
chaabo	שעבו
petru	פיטרו
mesbah	מסבאח
zimmer	זימר
graafschap	גראפשאפ
thwaite	תואיט
selten	סלטן
fiore	פיורי
christy	קריסטי
hauptmann	האופטמאן
perrin	פירין
kalam	קלאם
smolarek	סמולאריק
rosti	רוסטי
bunton	באנטון
herold	הרולד
baljic	באליטש
bouboulina	בובולינא
kalaf	קאלאף
kristiansen	קריסטיאנסן
phillip	פיליפ
worthington	ורתינגטן
dmitriy	דמיטרי
dorji	דורג'י
nyandoro	ניאנדורו
alona	אלונא
ted	טד
bogota	בוגוטא
aloni	אלוני
jalal	ג'לאל
mykolaiv	מיקולאיב
rammal	רמאל
qasim	קאסים
wight	ואיט
luol	לואל
mononoke	מונונוק
lev	לב
davinio	דאוויניו
herda	הירדא
iberia	איביריא
morishima	מורישימא
zoetermeer	זויטרמיר
geagea	געגע
puchner	פוכנר
bommer	בומר
albaath	אלבעת
korolyov	קורוליוב
mansare	מאנסארי
chiune	צ'יונה
ghiggia	גיגיא
dior	דיור
bixente	ביסינטי
frings	פרינגז
georgescu	ג'ורג'סקו
selene	סילין
mersenne	מירסין
niccolo	ניקולו
verdi	וורדי
liu	לו
lasker	לאסקר
escobar	אסקובאר
pisa	פיזא
giresse	גיריסי
barcham	ברצ'ם
verde	ורדי
lowry	לאורי
lerond	לירונד
panandetiguiri	פאנאנדיטיגוירי
perutz	פירוץ
vieri	ויירי
miladinovic	מילאדינוביטש
diffie	דיפי
moldova	מולדובא
shakespeare	שקספיר
rapoport	ראפופורט
alanwar	אלאנואר
tamil	טאמיל
tiasse	טיאסי
maillol	מאיול
trapani	טראפאני
renault	רינולט
boreanaz	בורינאז
gianluca	ג'אנלוקא
lavrov	לאברוב
snorri	סנורי
mazut	מאזוט
laurence	לורנס
payton	פייטון
decius	דקיוס
schnabel	שנאבל
watt	ואט
alberta	אלברטא
martov	מארטוב
calabria	קאלאבריא
pollard	פולארד
billy	בילי
rene	רנה
mukerji	מוקרג'י
walworth	ואלוורת
spacek	ספייסק
rafael	רפאל
ruiz	רויז
okko	אוקו
sudarsono	סודארסונו
clyde	קלייד
evander	איבאנדר
pacheco	פאצ'קו
tayeb	טייב
palma	פאלמא
romuald	רומאלד
palme	פאלם
saad	סעד
jennings	ג'נינגז
mimouna	מימונה
adrian	אדריאן
mbia	מביא
pastan	פאסטאן
maceio	מאסיו
mosaddeq	מוסאדק
cerf	סירף
saban	סאבאן
shirai	שיראי
sakaguchi	סאקאגוצ'י
simonetta	סימוניטא
hyori	היורי
feridun	פרידון
berkman	בירקמאן
ingeborg	אינגיבורג
raffaele	רפאלי
herodotus	הירודוטוס
jencks	ג'נקס
tessho	טישו
krul	קרול
reid	ריד
pound	פאונד
gosling	גוסלינג
stephanie	סטיפאני
konno	קונו
galal	גלאל
aljabal	אלג'בל
simple	סימפל
guerin	גוארין
tefilo	טפילו
sionko	סיונקו
saberi	סאברי
lei	ליי
jonny	ג'וני
hayez	האיז
jaziri	ג'זירי
rabuel	ראבואל
jawed	ג'אווד
hasan	חסן
hayes	הייז
purcell	פורסל
feingold	פאינגולד
hayek	חאיק
talabani	טאלבאני
maqam	מקאם
torquato	טורקואטו
kenzaburo	קנזאבורו
hendel	הנדל
proxima	פרוקסימא
parks	פארקס
imre	אימרי
shahnameh	שאהנאמה
bonnard	בונארד
angela	אנגילא
noble	נובל
kaboul	קאבול
cobeno	קובינו
iglesias	איגליסיאס
coste	קוסט
costa	קוסטא
denisov	דיניסוב
frontera	פרונטירא
zisis	זיסיס
lassalle	לאסאל
rikiya	ריקיא
fognini	פוניני
ledesma	לידיסמא
minavand	מינאואנד
neville	נוויל
islam	איסלאם
sedna	סידנא
byrne	בירן
helena	הלנא
schwartz	שוארץ
yoshinaka	יושינאקא
skopje	סקופיי
drissa	דריסא
xiaoxu	שיאושו
tsuboi	טסובוי
bassem	באסם
swayze	סוייזי
duchovny	דוכובני
pantoliano	פאנטוליאנו
oti	אוטי
mayer	מאיר
kathleen	קאתלין
mendel	מנדל
snoop	סנופ
papua	פאפוא
pitesti	פיטיסטי
thabit	תאבט
duvalier	דובאלייה
houssine	חוסין
erikson	אריקסון
shilka	שילקא
kutaisi	קוטאיסי
muhammed	מוחמד
yasuo	יאסו
safranek	סאפראניק
rijkaard	ריקארד
gyula	גיולא
barkley	בארקלי
apollinaire	אפולינייר
pekerman	פקרמאן
bisson	ביסון
zewlakow	זולאקו
donna	דונא
assoumani	עסומאני
borriello	בוריילו
reichstein	ראיכשטאין
atahualpa	אטאואלפא
kerckhoffs	קירקהופס
bharrat	באראט
ayrshire	אירשאיר
tenji	טינג'י
saionji	סאיונג'י
savio	סאביו
sylla	סילא
cappadocia	קאפאדוקיא
nikos	ניקוס
mommsen	מומסן
raviv	רביב
vermeer	ורמיר
tisdale	טיסדייל
tusseau	טוסו
keith	קית
jabal	ג'בל
levin	לוין
brandt	בראנט
troost	טרוסט
keita	קייטא
vlaovic	וולאוויטש
lawrence	לורנס
elbaradei	אלבראדעי
nasib	נסיב
shapur	שאפור
yaakov	יעקוב
benaglio	בינאגליו
grenville	גרנביל
irvine	אירבאין
geena	גינא
romania	רומייניה
franck	פראנק
taisho	טאישו
narmer	נארמר
szentmihalyi	סזינטמיהאלי
tarzan	טרזאן
koga	קוגא
perry	פירי
cabanas	קאבאנאס
larcher	לארשה
emma	אימא
elfriede	אלפרידי
kapitsa	קאפיטסא
damir	דמיר
hector	היקטור
nayef	נאיף
theiler	טילר
ludvik	לודביק
tamer	טאמר
malawi	מאלאוי
zakuani	זאקואני
martinelli	מארטינילי
monterroso	מונטירוסו
deplace	דיפלאס
kumm	קום
dien	דין
lacombe	לאקומב
beyonce	ביונסי
biaggio	ביאג'יו
del	דיל
cavenaghi	קאוונאגי
suvari	סובארי
maddah	מדאח
chopin	שופאן
stari	סטארי
kaltz	קאלץ
lineker	ליניקר
shawarma	שאורמא
franklin	פראנקלין
eleftherios	אליפתיריוס
basil	באסל
gerald	ג'ראלד
smits	סמיטס
tengiz	טינגיז
clare	קלייר
rik	ריק
vreijsen	וריסן
vik	ויק
hediger	הדיגר
nancy	נאנסי
clark	קלארק
jongbloed	יונגבלויד
nik	ניק
goulon	גולון
khurtsilava	חורטסילאבא
daibes	דעיבס
octonion	אוקטוניון
chagall	שאגאל
ternopil	טרנופיל
marks	מארקס
katan	קטן
marko	מארקו
florida	פלורידא
mehdi	מהדי
calatrava	קאלאטראבא
saratov	סאראטוב
lerdorf	לרדורף
valentin	عאלנטין
serra	סירא
novartis	נובארטיס
hamer	האמר
savicevic	סאביצ'ביטש
eduard	אדוארד
samuel	סאמואל
miescher	מישר
gren	גרין
kenji	קנג'י
shimla	שימלא
hamed	חאמד
jellinek	יליניק
alex	אלקס
hajeri	חג'רי
jeonghui	ג'יונגהוי
rapaic	ראפאייטש
bajram	באירם
charpenet	צ'ארפיניט
toulalan	טולאלאן
ladovsky	לאדוביסקי
guadiana	גואדיאנא
eastcote	איסטקוט
antonius	אנטוניוס
rotblat	רוטבלאט
katsu	קאטסו
rodolphe	רודולף
baramidze	באראמידזה
sigmund	סיגמונד
henrique	הנריקה
held	הילד
tornatore	טורנאטורי
pearson	פירסון
laroui	לערוי
idris	אידריס
feld	פילד
bogdan	בוגדאן
harrell	הארל
dora	דורא
poti	פוטי
mokdad	מוקדאד
meliton	מיליטון
sancho	סאנשו
yacef	יאסף
moti	מוטי
kunishige	קונישיגי
zhirkov	ז'ירקוב
tammuz	תמוז
claudette	קלודט
kadeer	קדיר
leonel	ליונל
dwayne	דויין
bajer	באיר
amira	אמירה
wilhelm	וילהלם
crayston	קרייסטון
batlles	באטלס
takumi	טאקומי
bundy	בנדי
natacha	נאטאשא
jamuovandu	ג'אמובאנדו
fayez	פאיז
ethylene	אתילין
habermas	האברמאס
stern	סטירן
radojko	ראדויקו
theo	תיו
mamluk	ממלוק
chafik	שפיק
ruddy	רודי
yagur	יאגור
dougray	דוגריי
assi	עאסי
jacky	ג'קי
maiga	מאיגא
david	דייוויד
kamel	קאמל
kamen	קאמן
kamei	קאמיי
buta	בוטא
hubbard	הובארד
katie	קייטי
durant	דוראנט
duncan	דנקאן
indyk	אינדיק
ghionea	גיוניא
plamen	פליימן
rosenberg	רוזנברג
wyatt	ואיאט
reina	ריינא
rasul	רסול
drioton	דריוטון
kouyoumdjian	קויומגיאן
baysse	באיס
schally	סקאלי
larsen	לארסן
pompilius	פומפיליוס
turk	טורק
piaui	פיאוי
telemann	טילימאן
chomsky	צ'ומסקי
mbuyane	מבויאן
heinz	היינז
kidman	קידמאן
westmoreland	וסטמורלאנד
minh	מין
lawal	לאואל
gallardo	גאלארדו
jacobi	ג'אקובי
jerry	ג'רי
tajalli	טג'לי
heini	היני
gekas	גיקאס
brest	בריסט
trujillo	טרוג'ילו
demidov	דמידוב
bradley	בראדלי
avnei	אבני
deisler	דאיסלר
heine	האינה
asror	אסרור
eminem	אימינם
grazia	גראזיא
vicelich	ויסליטש
yugoslavia	יוגוסלאביא
toshiyuki	טושיוקי
kemoko	קימוקו
oster	אוסטר
morgenstern	מורגנסטירן
ayalon	אילון
stroustrup	סטרוסטרופ
jammeh	ג'אמע
capua	קאפוא
puzo	פוזו
nativ	נתיב
bert	ברט
sassari	סאסארי
gavin	גאבן
golbourne	גולבורן
cusack	קוזאק
willard	וילארד
jol	ג'ול
richelieu	רישיליו
rimet	רימיט
herget	הרגט
olympias	אולימפיאס
dozy	דוזי
baroti	בארוטי
nekounam	נקונאם
dacia	דאסיא
salim	סלים
altman	אלטמאן
livio	ליוויו
rajab	רג'ב
camel	קאמל
lyudmila	לודמילא
ponaryo	פונאריו
montevideo	מונטיבידיו
hanoi	האנוי
zevulun	זבולון
fargeon	פארגיון
renaud	רינו
kakuei	קאקויי
osho	אושו
borgo	בורגו
millard	מילארד
gueye	גויי
sigourney	סיגורני
mehmet	מחמט
stella	סטילא
nawaz	נאואז
coulibaly	קוליבאלי
lesniak	לסניאק
lordi	לורדי
tubman	טובמאן
piturca	פיטורקא
garzon	גארזון
edouard	אדוארד
karoui	קרוי
wilkshire	וילקשיר
romer	רומר
fleihan	פליחאן
djorkaeff	דג'ורקאייף
vicky	ויקי
tareq	טארק
cox	קוקס
croydon	קרוידון
romeo	רומיו
chantal	שאנטאל
vicki	ויקי
rous	רוס
cartwright	קארטראיט
berti	ברטי
gambon	גאמבון
majalli	מג'לי
lous	לוס
beckham	בקהאם
mudhafar	מוזפר
alvaro	אלבארו
ander	אנדר
pirandello	פיראנדילו
berri	ברי
makelele	מאקיללי
saree	סארי
fedor	פידור
pape	פאפי
storari	סטורארי
bernardino	ברנארדינו
dinara	דינארא
kanoute	קאנוטי
salomon	סאלומון
kunert	קונרט
fouine	פוין
brunetti	ברוניטי
aurelius	אוריליוס
leterrier	לטרייר
kemp	קמפ
kolmogorov	קולמוגורוב
blanka	בלאנקא
labaki	לאבאקי
vujicic	ביוטיטש
alikhani	עליחאני
malin	מאלין
cryptozoology	קריפטוזואולוג'י
bjorkman	ביורקמאן
breitner	בראיטנר
bauhin	בוהין
moss	מוס
marcia	מארסיא
meir	מאיר
soren	סורין
kone	קוני
gerry	גירי
deir	דיר
geir	גיר
belin	בילין
slavkov	סלאבקוב
farrell	פאריל
aron	ארון
willem	וילם
nigeria	נאיג'יריא
wellhausen	ולהאוזן
ryedale	ראידיל
lescott	ליסקוט
pakistan	פאקיסטאן
kalabane	קאלאבאן
traian	טראיאן
steele	סטיל
bitat	ביטאט
libeskind	ליבסקינד
polo	פולו
bitar	ביטאר
etienne	אטיין
britney	בריטני
robbins	רובניז
ogogo	אוגוגו
pontoppidan	פונטופידאן
euglena	יוגלינא
dzajic	דזאג'יטש
borana	בוראנא
summerbee	סאמרבי
ralf	ראלף
abud	עבعד
murdoch	מורדוק
ziani	זיאני
melamed	מלמד
segal	סיגאל
pitt	פיט
ritt	ריט
ramesses	רמסיס
druze	דרוז
mitt	מיט
seidath	סיידאת
makoto	מאקוטו
nicky	ניקי
mizushima	מיזושימא
strontium	סטרונטיום
hozumi	הוזומי
camaro	קאמארו
zlatko	זלאטקו
hippolyte	היפוליט
lahoud	לחוד
heinrich	הינריך
sauer	סאוור
heng	הינג
satyajit	סאטיאג'יט
zurab	זוראב
sari	סרי
joji	ג'וג'י
koji	קוג'י
isidore	איזידור
maslow	מאסלו
ziad	זיאד
interpol	אינטרפול
orlandoni	אורלאנדוני
riad	ריאד
feliu	פילאיו
pogatetz	פוגאטיץ
rony	רוני
sony	סוני
shimomura	שימומורא
merbah	מרבאח
cahill	קאהיל
behzadi	בהזאדי
vasarely	ואסארלי
davala	דאואלא
martins	מארטינז
paille	פייל
martens	מארטינז
nadav	נדב
siniora	סניורה
lazaroni	לאזארוני
mohs	מוס
loren	לורין
stielike	סטיליקה
dalia	דאליא
harrison	האריסון
yukino	יוקינו
maik	מאיק
wordsworth	וורדזוורת
malouda	מאלודא
theuriau	טוריו
parietti	פאריאטי
penh	פן
masahiro	מאסאהירו
miami	מאיאמי
sanogo	סאנוגו
dion	דיון
koren	קורן
jaroslaw	יארוסלו
case	קייס
tachiki	טאטשיקי
roman	רומאן
korea	קוריא
blaine	בליין
vojtech	בויטיטש
dirani	דיראני
kiichiro	קיטשירו
blaise	בלייז
lubitsch	לוביטש
julien	גול'יאן
hijab	ח'יגאב
domeyko	דומייקו
makassar	מאקאסאר
heisenberg	הייזנבירג
serpentinite	סרפנטינאיט
capparoni	קאפארוני
sheryl	שיריל
alton	אלטון
stokes	סטוקס
maybach	מייבאך
moraru	מורארו
vijay	ויג'יי
zucchero	זוקירו
kela	קילה
yade	יאד
renones	רינוניס
thompson	טומסון
tursunov	טורסנוב
sheetrit	שטרית
nacer	נאסר
gaspard	גאספאר
belarus	בלארוס
rhodesia	רודיסיא
sucre	סוקר
bering	בירינג
shahab	שהאב
kareem	קרים
boonen	בונן
bellamy	בילאמי
zambrotta	זאמברוטא
barbados	בארבאדוס
galil	גליל
nagui	נאגי
galic	גאליק
gennady	גינאדי
wiesel	ויסל
wesley	ויסלי
unilever	יוניליבר
salama	סלאמה
tarif	טריף
sluiter	סלויטר
chauveau	שובו
murdock	מרדוק
sofer	סופר
valcareggi	ואלקארידג'י
maccoby	מאקובי
luce	לוס
tampere	טאמפירי
reed	ריד
mobius	מוביוס
issta	איסטא
goldwater	גולדווטר
batteux	באטו
frisch	פריש
dabo	דאבו
zerhouni	זרהוני
mireille	מיריי
mikko	מיקו
yomi	יומי
elton	אלטון
barranquilla	באראנקוילא
bertoni	בירטוני
rastafari	ראסטאפארי
bertini	ברטיני
yannick	יאניק
pana	פאנא
qana	קאנא
datsakorn	דאטסאקורן
barenboim	בארינבוים
hana	הנא
fumimaro	פומימארו
jana	יאנא
serao	סיראו
lana	לאנא
gomes	גומיז
nana	נאנא
haytham	היתם
marach	מאראצ'
dana	דאנא
karnei	קארניי
corey	קורי
thom	טום
maryam	מריאם
kyuma	קיומא
kidd	קיד
hestia	הסטיא
kleberson	קליברסון
walaza	ואלאזא
tanzan	טאנזאן
evgeny	איבגיני
rimini	רימיני
holzenbein	הולזנבאין
sandrelli	סאנדרילי
reiser	רייזר
makarios	מקאריוס
huesca	הואסקא
merom	מרום
bamrung	באמרונג
yamashita	יאמאשיטא
managua	מאנאגוא
salk	סולק
berkshire	בירקשיר
tullio	טוליו
numa	נומא
tayseer	טאיסיר
dorfner	דורפנר
besant	ביזנט
transkei	טראנסקיי
bamlett	באמלט
wawrzyniak	ואורזניאק
hans	האנס
gutierrez	גוטייריז
weah	ויא
degas	דיגא
shahd	שאד
jiechi	ג'יצ'י
poitier	פואטייה
dave	ייב
geraldine	ג'ראלדין
arsen	ארסן
fares	פארס
tabarez	טאבארז
dinos	דינוס
goren	גורן
collin	קולן
nippon	ניפון
robin	רובן
rickman	ריקמאן
martinez	מארטיניז
brody	ברודי
nakasone	נאקאסונה
dorian	דוריאן
fourier	פורייר
maillet	מיילט
atlantic	אטלאנטיק
jettou	ג'טו
kensington	קנסינגטון
slim	סלים
sato	סאטו
sissoko	סיסוקו
mikari	מיקארי
rehavam	רחבעם
verilog	וירילוג
nato	נאטו
shore	שור
fridtjof	פרידג'וף
shilton	שילטון
boutlilisse	בוטליליס
maher	מאהר
josephs	ג'וסיפז
magen	מגן
ryoma	ריומא
amal	אמל
nikolayev	ניקולאייב
page	פייג'
hickman	היקמאן
juliano	ג'וליאנו
ostrava	אוסטראבא
sufyan	סופיאן
malakian	מלקיאן
staten	סטאטן
gennadi	גינאדי
mt	מט
mlađan	מלאדיאן
amuro	אמורו
rykov	ריקוב
rapp	ראפי
ponnet	פוניט
zubeidi	זוביידי
azarenka	אזארינקא
harith	חארית
baibars	באיבארס
pagnani	פאניאני
hari	הארי
shailene	שיילין
dzhokhar	ג'וחר
meissen	מיסן
bilic	ביליטש
nathan	נייתן
frodo	פרודו
erie	אירי
prometheus	פרומיתיוס
curro	קורו
mzali	מזאלי
jenni	ג'ני
pattison	פאטיסון
mezey	מיזי
voltaire	וולטייר
hideki	הידיקי
ladislav	לאדיסלאב
sakimoto	סאקימוטו
fahrudin	פאהרודן
cahors	קאהור
astaire	אסטייר
krol	קרול
fighting	פאיטינג
matisse	מאטיס
haberkorn	האברקורן
camus	קאמו
wenger	וינגר
juhasz	ג'והאז
schafik	שפיק
mitsubishi	מיטסובישי
gercaliu	גירקאליו
nakahara	נאקאהארא
wangari	ואנגארי
bettega	ביטיגא
cleber	קליבר
mursal	מורסאל
sheen	שין
edgar	אדגאר
bangka	באנגקא
cody	קודי
hilton	הילטון
arthur	ארתור
bartolomeu	בארתולומיו
azar	אזאר
miyazawa	מיאזאוא
trondheim	טרונדהאים
shinto	שינטו
jezek	יזיק
filip	פיליפ
hannibal	האניבאל
mehlis	מיליס
bayezid	באיזיד
shinzo	שינזו
fukunishi	פוקונישי
seksan	סאקסאן
wilton	וילטון
rubin	רובין
haas	האס
kit	קיט
wallace	ואלאס
hirohashi	הירוהאשי
luhansk	לוהאנסק
tugay	טוגאי
kocsis	קושיס
shinkichi	שינקיצ'י
hashomron	השומרון
hayflick	הייפליק
salford	סאלפורד
bashir	בשיר
kasdi	קאסדי
avigdor	אביגדור
grava	גראבא
ghanem	גאנם
emo	אימו
hus	הוס
eldad	אלדד
belleri	בלירי
samtredia	סאמטרידיא
munk	מנק
sandri	סאנדרי
gus	גאס
goma	גומע
lamu	לאמו
horst	הורסט
goodison	גודיסון
stepney	סטיפניי
fortuno	פורטונו
krystian	קריסטיאן
hemingway	המינגווי
nermin	נרמין
agab	עגב
catalina	קאטאלינא
raimi	ראימי
fadlan	פדלאן
minami	מינאמי
vujanovic	בויאנוביטש
pinter	פינטר
lancashire	לאנקשיר
nurenberg	נורינבירג
norgay	נורגיי
masaaki	מאסאקי
saphir	ספיר
almanfaluti	אלמנפלוטי
yemin	ימין
constant	קונסטאנט
homaidan	חומידאן
annunziata	אנונסיאטא
sassoon	סאסון
halford	האלפורד
rikdo	ריקדו
spyridon	ספירידון
mercator	מירקאטור
matus	מאטוס
venice	וניס
hammoud	חמוד
fernando	פרנאנדו
ellen	אלן
yaokun	יאוקון
dolce	דולצ'ה
ziyi	זיי
lewis	לויס
melchior	מלקיור
ludovic	לודוביק
wangchuck	ואנגצ'וק
koharu	קוהארו
paradorn	פאראדורן
nicole	ניקול
yangon	יאנגון
morse	מורס
deodoro	דאודורו
christensen	קריסטנסן
masinga	מאסינגא
navarro	נאבארו
ephraim	אפרים
stievenard	סטיבינארד
zambelli	זאמבילי
kabuki	קאבוקי
azali	אזאלי
oliveira	אוליביירא
berman	ברמאן
karlovy	קארלובי
loos	לוס
gan	גאן
iordanescu	יורדאניסקו
djawadi	ג'אואדי
kostic	קוסטיטש
lloyd	לויד
massey	מאסי
habash	חבש
hartree	הארטרי
djibril	ג'יבריל
moumouni	מומוני
miyazaki	מיאזאקי
bagdadi	בגדאדי
guzzanti	גוצאנטי
hisato	היסאטו
quentin	קוינטין
sada	סאדא
cohen	כהן
dekel	דקל
tokyo	טוקיו
birnbaum	בירנבאום
richert	ריצ'רט
nada	נאדא
mcmanaman	מאקמאנאמאן
dada	דאדא
efraim	אפרים
hugo	היוגו
rafi	רפי
lugo	לוגו
mcneill	מקניל
kafi	קאפי
nafi	נאפי
langton	לאנגטון
hadzibegic	האדזיביגיטש
helou	חלו
valery	וואלרי
dreamworks	דרימוורקס
gonzalo	גונזאלו
bambang	באמבאנג
jurg	יורג
aljaber	אלג'אבר
dziri	דזירי
landreau	לאנדרו
cudicini	קודיצ'יני
epstein	אפסטין
rothman	רותמאן
german	ג'רמאן
luca	לוקא
chiacchio	צ'יאקיו
derbent	דירבינט
israel	איזריל
stowe	סטו
ramires	ראמירס
terme	טירמי
zakharov	זאכארוב
jamalzadeh	ג'מאלזאדה
barthez	בארטיז
humpty	האמפטי
rushmore	רשמור
boleyn	בולין
bloom	בלום
paramo	פאראמו
recife	רסיפי
jaaskelainen	יאסקילאינן
stockholm	סטוקהולם
mascherano	מאסקיראנו
hoshyar	הושיאר
statham	סטאתאם
panadol	פאנאדול
hoffmann	הופמאן
zanetic	זאנטיק
alicia	אליסיא
schmeichel	שמאיקל
kosugi	קוסוגי
natasha	נאטאשא
joe	ג'ו
prieto	פרייטו
noe	נוי
luzzatto	לוזאטו
ghazi	גאזי
coe	קו
yvon	יבון
shoshana	שושנה
soweto	סויטו
centauri	סנטורי
laville	לאביל
sheffield	שיפילד
jerome	ג'רום
potsdam	פוטסדאם
lepine	ליפאין
tomas	טומאס
sundell	סאנדל
gokdeniz	גוקדניז
yoshito	יושיטו
jumblatt	ג'ונבלאט
cave	קייב
turan	טוראן
salbutamol	סאלבוטאמול
vejic	ויג'יטש
miller	מילר
kyu	קיו
amir	עאמיר
florentino	פלורנטינו
sergey	סירגיי
shafik	שפיק
sweid	סויד
glau	גלאו
smush	סמאש
schwimmer	שוימר
magnificat	מאניפיקאט
stratford	סטראטפורד
moritz	מוריץ
govou	גובו
smashnova	סמאשנובא
tiberius	טאיביריאס
hatoyama	האטויאמא
rudakov	רודאקוב
serengeti	סירינגיטי
bouma	בומא
rustavi	רוסטאבי
giza	גיזה
nahla	נחלה
paganini	פאגאניני
anno	אנו
tram	טראם
farrokhzad	פרוכזאד
adwan	עדואן
flamini	פלאמיני
djian	דג'יאן
bram	בראם
guimard	גימאר
yasin	יאסין
hay	היי
moawad	מועואד
kay	קיי
furuya	פורויא
may	מיי
bay	ביי
cuiaba	קויאבא
aranha	אראנא
gabilondo	גאבילונדו
heshmat	חשמט
elliot	אליוט
pygmalion	פיגמאליון
yamoussoukro	יאמוסוקרו
taga	טאגא
iskra	איסקרא
meshal	משעל
castilla	קאסטילא
garibaldi	גאריבאלדי
amram	עמרם
gerhard	גרהארד
unix	יוניקס
hispaniola	היספאניולא
carvalho	קאראבאלהו
gaga	גאגא
marino	מארינו
manninger	מאנינגר
beidas	ביידאס
fyodor	פיודור
sonko	סונקו
mesrob	מסרוב
pete	פיט
katerina	קאטרינא
georgy	ג'ורג'י
kelley	קילי
weaver	ויבר
drucker	דרוקר
xabi	שאבי
eagleton	איגלטון
pfeiffer	פפאיפר
raffi	רפי
mundell	מאנדל
mullery	מולרי
floyd	פלויד
tina	טינא
kaj	קאי
karlovic	קארלוביטש
mittal	מיטאל
murat	מוראט
kardec	קארדק
lancelot	לאנסלוט
tchami	טשאמי
fuchs	פוקס
suker	סוקר
shan	שאן
socrates	סוקראטס
susilo	סוסילו
khan	חאן
murad	מוראד
abercrombie	אברקרומבי
semshov	סימשוב
reiki	רייקי
zinn	זין
pero	פירו
woods	וודז
maqluba	מקלובה
rui	רוי
nero	נירו
hui	הוי
majus	מג'וס
drummond	דרומונד
motahhari	מוטהרי
cris	קריס
pocatello	פוקאטילו
cassatt	קאסאט
hayden	האידן
nazli	נאזלי
queiroz	קירוז
jaidi	ג'אידי
anne	ען
natascha	נאטאשא
walzer	ואלצר
haymanot	האימאנוט
snir	סניר
dretar	דריטאר
heiko	הייקו
dossena	דוסינא
colombo	קולומבו
griffith	גריפית
macdonald	מאקדונאלד
kristof	קריסטוף
hertford	הירטפורד
litvinenko	ליטבינינקו
lindelof	לינדלוף
lau	לאו
behan	ביהאן
kubo	קובו
vemic	וימיטש
gediminas	גידימינאס
dr.	דקטור
kanpur	קאנפור
domagk	דומאק
nambu	נאמבו
yksel	יקסיל
pompeo	פומפיו
winslow	וינסלו
wilshere	וילשיר
sebastien	סיבאסטיאן
ayil	עאיל
mimoun	מימון
jouhaux	ג'והו
capri	קאפרי
tymoschuk	טימושוק
forsyth	פורסאית
ramage	ראמאג'
nebahat	נבאהט
servet	סרוויט
asakir	עסאקיר
ashdod	אשדוד
patton	פאטן
lionel	לאיונל
kahramanmaras	קהרמאנמאראס
simbi	סימבי
kuroda	קורודא
axum	אקסום
lindsey	לינדסיי
howe	האו
adelaide	אדיליاד
jurota	ג'ורוטא
fadiga	פאדיגא
salekhard	סאלכארד
justine	ג'אסטין
salva	סאלבא
walle	וולי
danner	דאנר
caterina	קאטירינא
woolley	וולי
mesut	מיסוט
shouaa	שועאע
sperl	ספארל
dudley	דאדלי
leon	ליון
farhi	פרחי
czeizler	קיזלר
servetus	סירביטוס
kankoune	קנקוני
nickelback	ניקילבק
somalia	סומאליה
sylvinho	סילביניו
bambi	באמבי
wolmar	וולמאר
baykal	באיקאל
sfar	ספאר
kilpin	קילפן
noboru	נובורו
rina	רינא
duran	דוראן
seferis	ספריס
patrice	פאטריס
mina	מינא
nina	נינא
bridge	ברידג'
dina	דינא
syagrius	סיאגריוס
shayne	שיין
hrubesch	הרובש
teresa	טיריזא
josh	ג'וש
cienfuegos	סיאנפויגוס
talpiot	תלפיות
mottaki	מוטאקי
tereza	טיריזא
vlada	וולאדא
gosh	גוש
miyu	מיו
italy	איטאלי
qaraoun	קרעון
pam	פאם
sam	סאם
marcin	מארצן
ham	חאם
jesus	חיסוס
hanbal	חנבל
ferdoos	פרדוס
meshulam	משולם
dam	דאם
ahern	אהירן
kufuor	קופור
kalla	קאלא
diogo	דיוגו
grimonpon	גרימונפון
cardozo	קארדוזו
henan	הינאן
arraba	אראבא
cambiasso	קאמביאסו
evariste	איבריסט
nafti	נפטי
rotana	רוטאנא
scarlett	סקארליט
veselinovic	ויסילינוביטש
brian	בריאן
nasri	נסרי
borsellino	בורסילינו
am	אם
zokora	זוקורא
rabiu	ראביו
kul	קול
sinclair	סינקלייר
dudka	דודקא
ganjavi	גאנג'אוי
gibbon	גיבון
ful	פול
gul	גול
zairi	זאירי
fredric	פרידריק
demis	דימיס
rabin	רבין
steyr	סטייר
prost	פרוסט
kuraki	קוראקי
weil	וייל
vito	ויטו
baram	באראם
miljanic	מילאניטש
isser	איסר
sabatini	סאבאטיני
trieste	טריסט
capone	קאפונ
salamanca	סאלאמאנקא
zelenka	זילינקא
shishakli	שישאקלי
tschumi	צ'ומי
trivic	טריביטש
ferlito	פרליטו
libertadores	ליברטאדוריס
nieminen	ניימינין
reitsch	ראיטש
donald	דונאלד
alisfahani	אלאיספהאני
tokio	טוקיו
beinisch	ביניש
eskell	אסקיל
poll	פול
faison	פייזון
tumelo	טומילו
bree	ברי
trail	טרייל
wuthrich	ווטריך
jiri	ג'ירי
kiri	קירי
goll	גול
sharma	שארמא
tilda	טילדא
bohlen	בולן
melki	מלקי
noah	נואה
claudio	קלאודיו
sayed	סייד
juuso	יוסו
kempes	קימפס
hawaii	האואי
ransome	ראנסום
john	ג'ון
kohn	קון
norrie	נורי
riveros	ריבירוס
mikimoto	מיקימוטו
hummelt	הומילט
esperanto	אספראנטו
bertos	בירטוס
hedi	הדי
hegel	היגל
naif	נאיף
lavra	לאברא
nikolaos	ניקולאוס
pistoia	פיסטויא
kashmir	קשמיר
bedi	בדי
sendhil	סנדהיל
hintermaier	הינטרמאיר
marta	מארטא
shamlou	שאמלו
alahram	אלאהראם
philips	פיליפס
colmar	קולמאר
senderos	סינדירוס
yakushin	יאקושין
galeazzo	גאליאצו
drew	דרו
robbie	רובי
figaro	פיגארו
europa	יורופא
sampi	סאמפי
ryo	ריו
borgetti	בורגיטי
jorgensen	יורגנסן
westermann	ויסטרמאן
wilkie	וילקי
germanium	גירמאניום
tobita	טוביטא
delfino	דלפינו
siyabonga	סייאבונגא
carnegie	קארנגי
nenad	נינאד
sebastiao	סבאסטיאו
paraguay	פאראגואי
delimkhanov	דלימכאנוב
silva	סילבא
woodgate	וודגייט
ruutel	רוטל
bozanic	בוזאניטש
yuzo	יוזו
gallois	גאלוא
corrie	קורי
hilde	הילדי
cunningham	קונינגהאם
tashiro	טאשירו
laporta	לאפורטא
vaduz	ואדוז
tiselius	טיסיליוס
tagore	טאגור
wilde	ואילד
bouchaib	בושעיב
bielsa	בילסא
grey	גריי
mujic	מוג'יטש
mccarthy	מקארתי
tuo	טו
ela	אלה
michelangelo	מאיקלאנג'ילו
jennifer	ג'ניפר
maimon	מאימון
eros	אירוס
popescu	פופיסקו
aikido	איקידו
kansas	קאנסאס
voreadis	ווריאדיס
sugita	סוגיטא
ashraf	אשרף
janssens	יאנסינס
mazarin	מאזארין
shakira	שאקירא
sandra	סאנדרא
cleanth	קלינת
fogh	פוג
gogh	גוג
olivero	אוליבירו
lipoma	ליפומא
carla	קארלא
lordan	לורדאן
zevi	צבי
boutahar	בוטהאר
pierangelo	פייראנגלו
nabih	נאבי
cyndi	סינדי
buenos	בוינוס
tsepo	ציפו
mariupol	מאריופול
levi	ליואי
rodriguez	רודריגיז
custers	קוסטרס
azilal	אזילאל
brocic	ברושיטש
taut	טאוט
koizumi	קויזומי
dominique	דומיניק
schwarzer	שוארצר
dacourt	דאקורט
bartolucci	בארטולוצ'י
yassine	יאסין
palacio	פאלאסיו
netafim	נטפים
wexler	וקסלר
bazzani	באזאני
jankovic	יאנקוביטש
bernays	ברנייז
hurt	הורט
theodora	תיודורא
karlsson	קארלסון
bsharri	בשארי
schmitt	שמיט
burt	בורט
weaving	ויבינג
milva	מילבא
tarlev	טארליב
mcindoe	מאקינדו
grassi	גראסי
scherbius	שירביוס
lipmann	ליפמאן
koloman	קולומאן
ikebana	איקיבאנא
fukuda	פוקודא
michel	מישל
shulamit	שולמית
zhekov	ז'קוב
michal	מיקאל
chilembe	צ'ילמבי
shlomo	שלמה
renquin	רינקוין
lumbini	לומביני
nathalie	נאטאלי
inca	אינקא
barack	ברק
katsuki	קאטסוקי
yann	יאן
michelle	מישל
diego	דייגו
uranus	אוראנוס
nattaporn	נאטאפורן
thaci	תאצ'י
lars	לארס
maranhao	מאראנהאו
bnei	בני
conchita	קונשיטא
jorvan	ג'ורבאן
sophus	סופוס
bardsley	בארדסלי
macias	מאסיאס
kaklamanakis	קאקלאמאנאקיס
sebastian	סיבאסטיאן
riskin	ריסקין
dahan	דהאן
peck	פיק
dichter	דיכטר
rimbaud	רימבו
srichaphan	סראישאפאן
mehmed	מחמד
sifi	סיפי
brodie	ברודי
braga	בראגא
barison	באריסון
yosef	יוסף
kees	קיז
fifi	פיפי
wisnieski	ויסניסקי
shomu	שומו
hirsch	הירש
zoltan	זולטאן
couperin	קופירין
colombia	קולומביא
mac	מאק
calderon	קאלדירון
masilela	מאסילילא
mpenza	מפינזא
guillaume	גויאם
frederik	פרידיריק
adriatic	אדריאטיק
mirnyi	מירני
heinze	האינז
green	גרין
iaquinta	איאקוינטא
josephine	ג'וזפין
sanchez	סאנשיז
glycine	גליסין
sanae	סאניי
apocalyptica	אפוקאליפטיקא
kandia	קאנדיא
shaun	שון
lukas	לוקאס
helsinki	הלסינקי
teko	טיקו
old	אולד
iskitim	איסקיטים
bordon	בורדון
rehema	רחימה
bordin	בורדין
leko	ליקו
yard	יארד
schami	שאמי
mischa	מישא
googoosh	גוגוש
debbie	דבי
harvey	הארבי
khizanishvili	קיזאנישבילי
ward	וורד
hard	הארד
smiljanic	סמיליאניטש
shawqat	שוקט
mcstay	מקסטיי
curtin	קורטין
trnava	טרנאבא
swaggart	סואגארט
tchomogo	טשומוגו
koevermans	קוברמאנס
tedd	טיד
shawkat	שאוקאט
queeny	קויני
farahani	פראהאני
emmanuel	עמנואל
hanzo	האנזו
veii	ויי
mahrous	מחרוס
burton	בורטן
bimkom	במקום
danielsen	דאניילסן
hiyama	היאמא
varallo	ואראיו
mehrdad	מהרדאד
clinton	קלינטון
gordon	גורדון
ruiter	רויטר
cairo	קאירו
remy	רמי
ashdown	אשדאון
savo	סאבו
berggreen	ברגרין
latimer	לאטימר
pfister	פפיסטר
vaclav	ואצלאב
hutchinson	הוטשינסון
theerawesin	תיראווסין
florent	פלורינט
mngomeni	מנגומיני
tudyk	טודיק
giagnoni	ג'אניוני
prokop	פרוקופ
barnard	ברנאר
yazid	יזיד
khumalo	קומאלו
mulilo	מולילו
boutros	בוטרוס
molina	מולינא
miyata	מיאטא
ferreira	פיריירא
steffen	סטיפן
sylvain	סילביין
burundi	בורונדי
pinhas	פנחס
prussia	פראשא
phnom	פנום
ragheb	ראגב
diderot	דידרו
lolita	לוליטא
buchner	בוכנר
amedeo	אמידיו
manaf	מנאף
takeshi	טאקישי
bercellino	ברצ'לינו
haan	האן
rumsfeld	ראמספילד
ballistic	באליסטיק
bennett	בנט
naan	נאן
little	ליטל
behrami	בהראמי
makonnen	מאקונין
marx	מארקס
caan	קאן
schuster	שוסטר
emden	אמדן
kirichenko	קיריצ'נקו
apollinaris	אפולינאריס
hemdan	חמדאן
stoltenberg	סטולטנברג
butler	באטלר
tadiran	טאדיראן
latvia	לאטביא
posey	פוזי
srinagar	סרינאגאר
frost	פרוסט
vlasic	ולאסיטש
nozomu	נוזומו
ani	אני
niall	ניאל
brunei	ברוניי
stendardo	סטינדארדו
ashkenazi	אשכנזי
zanetti	זאניטי
horna	הורנא
jospin	ג'וספאן
horne	הורן
cumin	קיומין
florin	פלורין
mohammed	מוחמד
leptin	ליפטין
nazik	נאזיק
kido	קידו
hiddink	הידינק
couto	קוטו
jaap	ג'אפ
pontes	פונטיס
stoker	סטוקר
wendee	ונדי
wiertz	וירץ
buinsk	בוינסק
slovakia	סלובאקיא
evans	איבאנז
pelle	פילי
kolkata	קלקטא
rothlisberger	רותליסבירגר
pelli	פילי
sibusiso	סיבוסיסו
dagestan	דאגסטאן
dragnea	דראגניא
shibata	שיבאטא
pazdan	פאזדאן
qaruh	קארוה
vitaliy	ויטאלי
mcqueen	מאקקוין
ajax	איג'אקס
zucker	זאקר
grunbein	גרונביין
muharram	מוחארם
iverson	איברסון
trygve	טריגבי
juande	חואנדי
cantona	קאנטונא
strasser	סטראסיר
harissa	חריסא
duhamel	דוהאמל
rodolfo	רודולפו
rosenblatt	רוזנבלאט
kadyrov	קדירוב
camille	קאמיל
kapoor	קאפור
pioline	פיולין
romulo	רומולו
maderno	מאדירנו
puli	פולי
pushkin	פושקין
fumio	פומיו
thembinkosi	תימבנקוסי
emerson	אמרסון
tafer	טאפר
hoskins	הוסקינס
bozoljac	בוזולג'אק
nagma	נאגמא
arafat	ערפאת
adler	אדלר
lynndie	לינדי
khodadad	חודאדאד
maximilien	מאקסמליאן
mcbeal	מקביל
apollo	אפולו
lacarne	לאקארן
haran	חאראן
kling	קלינג
shinrikyo	שינריקיו
ivry	איברי
muscat	מוסקאט
joachim	ג'ואקים
mairead	מיריד
copenhagen	קופנהאגן
murty	מורטי
melville	מילביל
reiziger	ראיזיגיר
ratko	ראטקו
honshu	הונשו
woodcock	וודקוק
petra	פיטרא
guadeloupe	גואדלופ
artemis	ארטימיס
petri	פיטרי
fiala	פיאלא
eboli	אבולי
popluhar	פופלוהאר
manning	מאנינג
oued	וד
sanader	סאנאדר
chirac	שיראק
chadili	שאדלי
methane	מיתיין
junghans	יונגהאנז
hollis	הוליס
tereshkova	טרשקובא
noriko	נוריקו
podesta	פודיסטא
geology	גי'ולוג'י
cyprus	סאיפרוס
paulina	פאולינא
len	לן
men	מן
giuliani	ג'וליאני
rovinj	רובינג'
valkyrie	ואלקירי
chappuzeau	שאפוזיו
mbo	מבו
mingyu	מינגיו
polly	פולי
dorigo	דוריגו
efrat	אפרת
heitinga	היטינגא
saivet	סאיביט
pim	פים
belitung	בליטונג
kim	קים
lodovico	לודוביקו
marco	מארקו
nogly	נוגלי
seppi	סיפי
toledo	טולידו
leekens	ליקנז
condoleezza	קונדוליזא
swaziland	סואזילאנד
bohdan	בודאן
rommel	רומל
zitka	זיטקא
mejdi	מג'די
sojourner	סוג'ורנר
haryana	האריאנא
su	סו
lucio	לוסיו
bu	בו
leonor	ליונור
theofanis	תיופאניס
florian	פלוריאן
lucia	לוסיא
essen	אסן
glover	גלובר
clint	קלינט
chamberlain	צ'יימברלין
sheridan	שירידאן
walt	ואלט
josef	ג'וסף
kelly	קילי
hawi	חאוי
forrester	פורסטר
luther	לותר
zubizarreta	זוביזאריטא
bulleh	בולה
lendvai	לינדבאי
lota	לוטא
bluitgen	בלוטגן
chanel	צ'אנל
sturt	סטורט
hsien	חסין
rotterdam	רוטרדאם
robben	רובן
hartmann	הארטמאן
shittu	שיטו
adonis	אדוניס
belmont	בלמונט
minamoto	מינאמוטו
johannesburg	ג'והאנסברג
valletta	ואליטא
corradi	קוראדי
tiberias	טאיביריאס
talmud	תלמוד
bastian	באסטיאן
florianopolis	פלוריאנופוליס
rollo	רולו
nobel	נובל
bismarck	ביסמארק
tork	טורק
dresden	דרסדן
diniyar	דינייאר
hellebuyck	היליבויק
mwaruwari	מוארווארי
bork	בורק
horowitz	הורוביץ
battista	באטיסטא
tirnanic	טירנאניטש
totma	טוטמא
chimbonda	צ'ימבונדא
yacob	יעקוב
hitzfeld	היצפילד
lazio	לאזיו
souness	סוניס
kariri	קרירי
karimi	קרימי
palau	פאלאו
robinho	רובינהו
fayol	פאיול
heaviside	היביסאיד
dmitriev	דמיטרייב
firman	פרמאן
lanark	לאנאנרק
nelly	נלי
kassir	קסיר
richie	ריצ'י
bea	בי
wozniak	וזניאק
majorca	מאיורקא
madonna	מאדונא
laudrup	לאודרופ
burns	בירנז
tajwid	תג'וויד
darcy	דארסי
paradiso	פאראדיסו
miley	מאילי
sasaki	סאסאקי
sayyid	סאייד
minagawa	מינאגאוא
rusedski	רוסדיסקי
tayma	טאימא
della	דילא
sarsur	סרסור
bongartz	בונגארץ
halevy	הלוי
edie	אדי
shipman	שיפמאן
zakaria	זקריא
yazalde	יאזאלדי
masashi	מאסאשי
ghannam	גנאם
shimshon	שמשון
malkhaz	מאלכאז
wataru	ואטארו
caniggia	קאניגיא
karanusic	קראנוסיטש
perl	פירל
aguilera	אגוילירא
darui	דארוי
montt	מונט
heynemann	היינימאן
canetti	קאניטי
tampa	טאמפא
berl	בירל
bella	בילא
abebe	אביבי
newsted	ניוסטד
bello	בלו
monte	מונטי
tsutomu	טסוטומו
felsner	פילסנר
earhart	אירהארט
nazif	נזיף
maya	מאיא
zhou	ז'ו
waldheim	ואלדהאים
nazim	נאזים
talal	טלאל
nazis	נאציז
saez	סאיז
ljubomir	ליובומיר
vinson	וינסון
salas	סאלאס
salar	סאלאר
srur	סרור
fort	פורט
degauque	דיגוק
ara	ערא
bramante	בראמאנטי
halevi	הלוי
thio	תיו
severus	סיבירוס
lewinsky	לוינסקי
tomoko	טומוקו
grossman	גרוסמאן
aloysius	אלאוישס
ohio	אוהיו
faltermeyer	פאלטרמאיר
vasari	ואסארי
gilead	גיליאד
michalis	מיקאליס
hellmut	הילמוט
list	ליסט
sandler	סאנדלר
yuryaku	יוריאקו
susic	סוסיטש
rameau	ראמו
carini	קאריני
plessers	פליסירז
itamar	איתמר
masami	מאסאמי
bakr	בקר
rizik	ריזיק
bhamdoun	בחמדון
markku	מארקו
renato	רינאטו
buryatia	בוריאטיא
romanians	רומייניאנז
ullman	אולמאן
papin	פאפין
gianni	גwאני
baqir	באקיר
brahma	בראהמא
nobre	נוברי
howells	האוולז
ballotta	באלוטא
menachem	מנחם
souk	סוק
rajko	ראיקו
giourkas	ג'ורקאס
carrey	קארי
kinney	קיני
huckabee	האקאבי
alistair	אליסטיר
rouwaida	רואידא
handler	האנדלר
hanif	חניף
mutarelli	מוטארילי
sangweni	סאנגויני
malcolm	מאלקולם
ebadi	עבאדי
wanis	ואניס
pagani	פאגאני
nomvethe	נומביטי
fredriksson	פרידריקסון
cordell	קורדל
jacquet	ג'אקה
pearce	פירס
kariokka	קאריוקא
winn	וין
tahiti	טאהיטי
mitropoulos	מיטרופולוס
mauroy	מורוי
linn	לין
slavonia	סלאווניא
lavronenko	לאברונינקו
jaber	ג'אבר
ned	נד
prado	פראדו
finn	פין
coventry	קובנטרי
rabbah	ראבא
lyonne	ליון
josu	חוסו
willis	ויליס
warnock	וארנוק
fleming	פלימינג
kinsey	קינזי
sali	סאלי
leilei	לייליי
hatem	חאטם
yadin	ידין
saeed	סעיד
carragher	קאראגר
niepce	ניפס
perlman	פרלמאן
kalililo	חלילילו
aqaba	עקבה
formosa	פורמוזא
walsh	ואלש
valeri	ואלירי
fazio	פאזיו
adam	אדם
fraser	פרייזר
sami	סאמי
keizo	קייזו
ayala	איילה
harlan	הארלאן
moshoeu	מושיו
kampf	קאמפף
madruzzo	מאדרוצו
junichiro	גוניטשירו
nivola	ניבולא
rexhepi	רקפי
musampa	מוסאמפא
rossini	רוסיני
kalac	קאלאטש
dicaprio	דיקפריו
augusto	אוגוסטו
attenborough	אטנבורו
shazar	שזר
clancy	קלאנסי
dietrich	דיטריך
mateo	מאטיו
rehhagel	ריהאגל
assaf	עסאף
wentworth	ונטוורת
wade	וייד
hunke	הונקה
komodo	קומודו
kishimoto	קישימוטו
rogerio	רוגיריו
basma	בסמה
barragan	בראגאן
knut	קנוט
shamma	שמה
janis	ג'אניס
dodoma	דודומא
munitis	מונאיטיס
cohade	קוהייד
tumart	טומארט
batatu	בטאטו
zuabi	זועבי
schumann	שומאן
aono	אונו
bono	בונו
mahut	מאהוט
madeira	מאדירא
marlon	מארלון
radwanska	ראדואנסקא
brechet	בריטשיט
haehnel	האהניל
rushdy	רושדי
minnie	מיני
magellan	מאגלאן
joyce	ג'ויס
berlusconi	ברלסקוני
luc	לוק
eliyahu	אליהו
chuikov	צ'ויקוב
hannes	האניס
maron	מארון
marom	מרום
shmona	שמונה
brook	ברוק
kateb	קאטב
sarraute	סארוט
sderot	שדרות
singh	סינג
metzelder	מצלדר
vesey	ויסי
nesta	נסטא
velha	ולהא
daneshvar	דאנשוור
lambrichts	לאמבריכטס
sawiris	סאויריס
shinawatra	שינאואטרא
mahyadi	מאהיאדי
venglos	וונגלוס
hattori	האטורי
melho	מלחו
ingmar	אינגמאר
carlsen	קארלסן
guillermo	גוילירמו
emmy	אמי
esna	אסנא
zimmerman	זימרמאן
kuszczak	קוצ'אק
karol	קארול
essam	עסאם
sega	סגא
dorothy	דורותי
taliban	טאליבאן
asia	איז'א
iii	אייי
brad	בראד
kazakhstan	קאזאכסטאן
dalal	דלאל
valentino	ואלנטינו
georgios	גיורגיוס
khater	חאטר
valentine	ואלנטין
corsetti	קורסיטי
dania	דאניא
haddock	האדוק
hannigan	האניגאן
helpman	הילפמאן
sawashiro	סאואשירו
mukasey	מוקייזי
camps	קאמפס
kliment	קלימנט
ramzan	רמזאן
zafour	זאפור
lukasz	לוקאס
meg	מיג
benazir	בנאזיר
canio	קאניו
katlego	קאטליגו
mandala	מאנדאלא
zvi	זבי
gaber	גאבר
fayyad	פאיאד
domingo	דומינגו
bertolt	ברטולט
cromwell	קרומוול
isis	אייסיס
nahum	נחום
krav	קרב
kerzhakov	קירזהאקוב
bandler	באנדלר
georgi	ג'ורג'י
bammer	באמר
bouzarah	בוזארה
pollak	פולק
deimos	דיימוס
natalia	נאטאליא
fahmi	פהמי
kist	קיסט
jacob	ג'ייקוב
wazzan	ואזאן
morgner	מורגנר
vincenzo	וינצ'ינזו
placente	פלאסנטי
navas	נאבאס
transat	טראנסאט
bismillah	ביסמילה
clampett	קלאמפיט
rateb	ראטב
rowen	רוון
fuseli	פוסלי
kotaro	קוטארו
vangelis	ואנגיליס
t	ט
kayumi	קאיומי
sakamoto	סאקאמוטו
constanta	קונסטאנטא
asatiani	אסאטיאני
ganim	גנים
sabau	סאבאו
sabat	סאבאט
tarantino	טאראנטינו
f	אף
machine	מאשין
aatef	עאטף
milad	מילאד
pykalisto	פיקאלסטו
tadic	טאדיטש
yakin	יאקין
gianluigi	ג'אנלויג'י
joao	ג'ואו
becher	בישר
bruner	ברונר
yiannis	יאניס
ganis	גאניס
burckhardt	בורקהארט
sadiq	סאדיק
benno	בינו
sabah	סבאח
rondonia	רונדוניא
cvetkovic	סביטקוביטש
delhi	דלהי
blake	בלייק
ceulemans	קוילמאנס
razvan	ראזבאן
benny	בני
darrell	דאריל
daar	דאר
ghezal	גזאל
syktyvkar	סיקטיבקאר
galvani	גאלוואני
soma	סומא
schneider	שנאידר
rabah	ראבח
lydia	לידיא
majewski	מאג'וסקי
mihoubi	מיהובי
shinkansen	שינקאנסן
yartsev	יארטסיב
tbilisi	טביליסי
meghni	מגני
lawton	לוטון
barbour	בארבור
gnako	גנאקו
morrow	מורו
laskarina	לאסקארינא
tambal	טמבל
kaplinsky	קאפלינסקי
varnhagen	וארנהאגן
stipe	סטיפ
abdullah	עבדאללה
reimann	ראימאן
breeze	בריז
severo	סיבירו
keane	קין
palahniuk	פאלאניוק
saddam	סדאם
rodney	רודני
lamyaghri	למיאגרי
loic	לואק
jaime	ג'יימי
dragan	דראגאן
benn	בן
gensho	גינשו
mbamba	מבאמבא
watros	ואטרוס
wasserman	ואסרמאן
rodzik	רודזיק
soyer	סויר
shay	שי
amanda	אמאנדא
lenev	לנב
gimme	גימי
shriki	שריקי
whitman	ויטמאן
cartagena	קארטאגינא
nessim	נסים
hadid	חדיד
massoud	מסעוד
mphela	מפילא
miron	מירון
wadih	ואדיח
fatton	פאטון
naohiro	נאוהירו
greene	גרין
valencia	ואלנסיא
korbut	קורבט
hosic	הוסיטש
logofet	לוגופיט
salvatore	סאלבאטורי
corbusier	קורבוסייה
lech	לך
yamadayev	יאמאדאייב
linus	לאינוס
cech	צ'ק
adhan	אדאן
vadim	ואדים
biber	ביבר
ferenc	פירינק
octavio	אוקטאביו
knobel	נובל
kirov	קירוב
kwanzaa	קואנזא
lucarelli	לוקארילי
diamantino	דיאמאנטינו
zerouali	זרואלי
jacek	ג'אסיק
laban	לבן
hardaway	הארדאויי
jensen	ג'נסן
dzurinda	דזורינדא
bingu	בינגו
topal	טופאל
tunis	טוניס
asuncion	אסונסיון
quim	קוים
suvorov	סובורוב
lilienthal	לילינטאל
michaels	מאיקלז
marzel	מארזל
quagliarella	קואליארילא
sellimi	סלימי
acrobat	אקרובאט
bertine	ברטין
zagallo	זאגאלו
zdenek	זדיניק
vassaras	ואסאראס
sara	סארא
choutos	צ'וטוס
wang	ואנג
mannin	מאנין
ettore	איטורי
gallice	גאליסי
tati	טאטי
limassol	לימאסול
sandro	סאנדרו
norizan	נוריזאן
dudayev	דודאייב
maeterlinck	מאטרלינק
edwin	אדוין
schlossberg	שלוסברג
amichai	עמיחי
brando	בראנדו
zgharta	זגארטא
total	טוטאל
midorikawa	מידוריקאוא
carrara	קארארא
josip	ג'וסיפ
cleveland	קליבלאנד
shiva	שיבא
neuville	נוביל
atar	עטאר
kiichi	קיצ'י
hephaestus	היפיסטוס
fernand	פרנאנד
ezra	עזרא
gautama	גוטאמא
danilo	דאנילו
wathiq	ואתיק
modibo	מודיבו
diskin	דיסקין
katongo	קאטונגו
grinder	גראינדר
houari	הוארי
rostom	רוסטום
veselin	וסילין
eliot	אליוט
fusi	פוזי
sisyphus	סיזיפוס
gonzaga	גונזאגא
nadia	נאדיא
geels	גילז
goring	גורינג
totoro	טוטורו
wright	ראיט
shigeru	שיגירו
nadir	נדיר
skerritt	סקיריט
ribisi	ריביסי
gregorio	גריגוריו
christa	קריסטא
zabaleta	זאבאליטא
jos	ג'וס
marica	מאריקא
hideaki	הידיאקי
steinitz	סטייניץ
agranat	אגרנט
rooney	רוני
hijazi	חיג'אזי
warraq	וראק
seinfeld	סיינפילד
suvrijn	סוברין
blondeau	בלונדו
huddlestone	האדלסטון
dupree	דופרי
karpinski	קארפינסקי
hayashi	האיאשי
jihad	ג'יהאד
hirschfeld	הירשפילד
sheringham	שירנגהאם
drenthe	דרינטה
ferrier	פירייה
slimane	סלימאן
buncol	בונקול
likud	ליכוד
budi	בודי
vagiz	ואגיז
dudi	דודי
tomasz	טומאס
python	פאיתון
alassad	אלאסד
mcauliffe	מאקאוליף
jozsef	ג'וזיף
manuele	מאנויל
heracles	היראקליס
christov	קריסטוב
hamm	האם
midori	מידורי
elektra	אלקטרא
sabato	סאבאטו
hakkinen	האקינן
sorrento	סורינטו
denktas	דנקטאס
valentina	באלנטינא
tomei	טומיי
revere	ריביר
badir	באדר
kleinert	קלאינירט
magic	מאג'יק
reem	רים
naismith	נייסמית
metzudat	מצודת
mr.	מיסטר
gaon	גאון
hoodia	הודיא
michiru	מיטשירו
francescoli	פראנסיסקולי
faten	פאטן
abboud	עבוד
cannon	קאנון
suurbier	סורבייר
hausmann	האוסמאן
hughton	היוטון
animaniacs	אנימאניאקס
nyerere	נירירי
grnemeyer	גרנמייר
sylvester	סילבסטר
nikopolidis	ניקופולידיס
michigan	מישיגאן
economist	אקונומיסט
leroux	לירו
stirling	סטירלינג
serginho	סירגינהו
davids	דייוידז
kakuro	קאקורו
rimitti	רימיטי
klaws	קלוס
theodoric	תיודוריק
chester	צ'סטר
houghton	הוטון
reyad	ריאד
togo	טוגו
perez	פיריז
daewoo	דאיוו
hikmat	חקמט
perec	פרק
hikmet	חיקמט
tzur	צור
nimeiry	נמיירי
monroe	מונרו
hitoshi	היטושי
busby	באסבי
joaquin	ג'ואקין
stech	סטיטש
serine	סירין
max	מאקס
moreau	מורו
hematocrit	הימאטוקריט
johann	יוהאן
xiang	קסיאנג
giichi	גיצ'י
hudgens	האדג'נז
seehawong	סיהאוונג
villarreal	וילאריאל
yafa	יאפא
hisham	הישאם
protocol	פרוטוקול
petropolis	פטרופוליס
rowan	רואן
korneyev	קורנייב
nafa	נפאע
cameroon	קאמירון
mazhar	מזהר
shalom	שלום
milan	מילאן
tov	טוב
collette	קוליט
birgit	בירגיט
levinger	לבינג'ר
bezos	ביזוס
gulbenkian	גולבנקיאן
phanrit	פאנריט
novin	נובין
stoor	סטור
johar	ג'והר
higgs	היגז
steinmeier	שטאינמאיר
burkina	בורקינא
beckenbauer	בקנבאור
lipton	ליפטון
patmos	פאטמוס
linux	לינוקס
imereti	אימיריטי
greiss	גריס
ababil	אבאביל
dunne	דון
benneteau	בניטו
dotan	דותן
gasquet	גאסקה
daimyo	דאימיו
heyse	הייס
ashcroft	אשקרופט
buble	בובלה
bunin	בונין
jane	ג'יין
wilder	ואילדר
victoria	ויקטוריא
elmore	אלמור
kristiansand	קריסטיאנסאנד
adnan	עדנאן
winslet	וינסליט
stanley	סטאנלי
kostas	קוסטאס
hasler	האסלר
persephone	פירסיפוני
thousand	תוסנד
walesa	ואליסא
ketone	קיטון
jomei	ג'ומיי
andres	אנדריס
montale	מונטאלי
gyorgy	גיורגי
hartnett	הארטניט
fuste	פוסטי
spycher	ספאיקר
tempelhof	טמפלהוף
patocka	פאטוקא
henkin	הנקין
millichip	מיליצ'יפ
siviglia	סיביליא
kaiafas	קאיאפאס
weizmann	ויצמן
valera	באלירא
colombier	קולומבייה
priscus	פריסקוס
emanuele	אמאנואל
visitor	ויסיטור
cleopatra	קליופאטרא
minsk	מינסק
sanguinetti	סאנגויניטי
clichy	קלישי
zamora	זאמורא
wegener	ווגנר
brent	ברינט
melissa	מליסיא
zaha	זהא
celtics	סלטיקס
bordet	בורדה
saha	סאהא
taha	טאהא
bresse	בריס
kovacevic	קובאטשיביטש
gardner	גארדנר
arend	ארינד
larfaoui	לערפאוי
whitney	ויטני
frantisek	פראנטיסק
vltava	ולטאבא
hernych	הירניטש
haidong	האידונג
yusef	יוסף
almajid	אלמג'יד
monrovia	מונרוביא
kaji	קאג'י
darwish	דרויש
macdiarmid	מאקדירמיד
marchena	מארצ'ינא
yaping	יאפינג
maalouf	מעלוף
carrero	קארירו
diakite	דיאקיטי
vered	ורד
carly	קארלי
chaabi	שעבי
demme	דים
batista	באטיסטא
rampal	ראמפאל
capcom	קאפקום
promethium	פרומיתיום
pettis	פטיס
stefanescu	סטיפאניסקו
hany	האני
theodoros	תיודורוס
dockx	דוקס
simic	סימיטש
reijiro	רייג'ירו
desiree	דיזירה
rizk	ריזק
kazuhiko	קאזוהיקו
tunney	טוני
emily	אמילי
salvadore	סאלבאדור
yahel	יאהיל
selkirk	סילקירק
gorky	גורקי
seman	סימאן
nefertiti	נפרטיטי
mcconaughey	מאקונאהי
pacifico	פאסיפיקו
tsarev	טסאריב
neptune	ניפטון
fourest	פוריסט
ljubljana	ליובליאנא
seattle	סיאטל
dimitar	דימיטאר
kyros	קירוס
mick	מיק
demirel	דימיריל
giannis	ג'יאניס
nuno	נונו
rosalind	רוזאלינד
ninomiya	נינומיא
teotihuacan	טיוטיהואקאן
mccoist	מקויסט
bouchardeau	בושארדיו
livorno	ליבורנו
saldana	סאלדאנא
saura	סאורא
aqel	עקל
sadako	סאדאקו
hudna	הודנה
samosa	סאמוסא
pozo	פוזו
shiri	שירי
nordtveit	נורדבייט
crudup	קרודאפ
kozo	קוזו
knuth	קנות
lymari	לימארי
hierro	היירו
donitz	דוניץ
kiyotaka	קיוטאקא
cornet	קורנה
marinca	מארינקא
zambezi	זאמביזי
buell	ביואל
ash	אש
arik	אריק
brik	בריק
winehouse	ואינהאוס
paqueta	פאקיטא
niue	ניו
indiumiii	אנדיומי
jackson	ג'אקסון
lusaka	לוסאקא
dolby	דולבי
caneira	קאנירא
mee	מי
attia	עטיה
gilad	גלעאד
naihoum	נאיהום
weddell	ודל
gomez	גומיז
queensland	קוינסלאנד
khali	קאלי
cristobal	קריסטובאל
kappei	קאפיי
meryl	מיריל
meidani	מידאני
sjaak	סיאק
nereo	ניריו
tullamore	טולאמור
besheer	בשיר
vandendaele	ואנדנדייל
kubala	קובאלא
malbranque	מאלבראנק
bergeroo	בירגירו
manzoni	מאנזוני
wakatsuki	ואקאטסוקי
sandy	סאנדי
binoche	בינוש
halilovic	חלילוביטש
victor	ויקטור
konoe	קונויה
estudiantes	אסטודיאנטיס
toyota	טויוטא
santamaria	סאנטאמאריא
bisset	ביסה
giora	גיורא
lecuona	ליקונא
kathmandu	קאתמנדו
holstein	הולסטין
beardsley	בירדזלי
chevrolet	שיברוליי
volcker	וולקר
leonhard	ליונהארד
warner	וארנר
surjak	סוריאק
calouste	קאלוסט
christofias	קריסטופיאס
barbarossa	בארבארוסא
doesburg	דוסבורג
standfest	סטאנדפיסט
derek	דרק
morrell	מורל
turteltaub	טירטלטאוב
badran	בדראן
kakihara	קאקיהארא
rami	ראמי
bertoli	בירטולי
murasaki	מוראסאקי
beschastnykh	ביצ'אסטניך
mami	מאמי
accra	אקרא
volkan	ולקאן
sampras	סאמפראס
kuwashima	קואשימא
kemal	קמאל
mauro	מאורו
ratzel	ראטזל
mauri	מורי
patty	פאטי
magnus	מאגנוס
chikhaoui	שיכאוי
baggio	באג'יו
maura	מורא
georgians	ג'ורג'ינז
braugher	ברויר
koyre	קוירי
brigitte	בריגיט
giannakopoulos	ג'יאנאקאפולוס
greaves	גריבז
bledel	בלדל
mamdouh	ממדוח
rybak	ריבאק
rahman	רחמן
conti	קונטי
yassin	יאסין
pozzo	פוצו
foxx	פוקס
cayetano	קאיטאנו
tatsukichi	טאטסוקיצ'י
redon	רידון
phillimon	פילימון
sadegh	סאדק
tristram	טריסטראם
chhetri	צ'טרי
sammer	סאמר
horikawa	הוריקאוא
irakli	איראקלי
mateut	מאטיוט
clinkenbeard	קלינקינבירד
gheorghe	גיורגי
pol	פול
srna	סרנא
furlong	פורלונג
jaurs	ג'אורס
bg	בג
jurica	יוריקא
graner	גראנר
mandy	מאנדי
kisnorbo	קיסנורבו
bacardi	באקארדי
sterjovski	סטריובסקי
husserl	הוסרל
mandi	מאנדי
manda	מאנדא
shin	שין
jonson	ג'ונסון
salih	סאלח
sheldon	שילדון
mirsadeghi	מירסאדקי
bush	בוש
conor	קונור
baartman	בארטמאן
theorell	טיורל
basto	באסטו
zurer	זורר
marquez	מארקיז
miyamoto	מיאמוטו
sarinana	סארינאנא
luigi	לויג'י
adi	עדי
cardoso	קארדוסו
ruben	רובן
morikawa	מוריקאוא
amartya	אמארטיא
lithuania	ליתואיניה
daniele	דניאל
qurei	קוריע
astrid	אסטריד
milos	מילוש
jun	ג'ון
hammett	האמיט
gamal	גמאל
marc	מארק
abdoulaye	עבדולאי
wendell	וינדל
kyrklund	קירקלונד
mandanda	מאנדאנדא
jandl	יאנדל
fahima	פהימה
klee	קליי
nasheed	נאשיד
chedid	שדיד
gamar	גמר
ghali	גאלי
maximilian	מאקסימיליאן
nicklas	ניקלאס
puttan	פוטאן
demeter	דימיטר
kundera	קונדירא
russia	ראשא
golgi	גולגי
indurain	אינדוריין
czerniatynski	זרניאטנסקי
ghaly	גאלי
mesa	מסא
tegucigalpa	טיגוסיגאלפא
vivo	ביבו
umar	עומר
spiro	ספירו
bunting	באנטינג
niang	ניאנג
cheyrou	צ'יירו
omar	עומר
kaddoumi	קדומי
gofman	גופמאן
emar	אימאר
kusch	קוש
boumediene	בומדין
craiova	קראיובא
arto	ארטו
walid	וליד
stasi	סטאזי
rahel	ראחיל
rostov	רוסטוב
shesternyov	שיסטרניוב
rabindranath	ראבנדראנאת
hatta	חטא
mihajlovic	מיהאילוביטש
lippmann	ליפמאן
sira	סירה
locarno	לוקארנו
satyagraha	סאטיאגראהא
proline	פרולין
kira	קירא
watts	ואטס
mira	מירא
saxony	סאקסוני
weissglass	וייסגלאס
ishtar	אשטאר
sinibaldi	סיניבאלדי
siti	סיטי
arabian	ארייביאן
matar	מטר
gerson	גרסון
marion	מאריון
buisson	בויסון
godwin	גודוין
acasuso	אקאסוסו
hess	הס
paulo	פאולו
haddad	חדאד
nasr	נסר
marian	מאריאן
maghreb	מאגרב
korolenkov	קורולנקוב
audo	אודו
vasile	ואסילי
sanbar	סנבר
schutz	שוץ
ljubisa	ליוביסא
pantanal	פאנטאנאל
lady	ליידי
johnson	ג'ונסון
chaiman	צ'אימאן
finnan	פינאן
blass	בלאס
matty	מאטי
lundin	לונדין
trier	טריר
quixote	קיוטי
mbeki	מביקי
suree	סורי
sabrina	סאברינא
yury	יורי
matti	מאטי
lima	לימא
nahman	נחמן
paulson	פולסון
tezuka	טיזוקא
lemerre	לומיר
shirokov	שירוקוב
ericson	אריקסון
sabri	סאברי
lothair	לותייר
sutton	סוטון
haeckel	היקל
ravitz	רביץ
veyron	ויירון
ledley	לידלי
naka	נאקא
collar	קולאר
stojkovic	סטויקוביטש
borrelli	בורילי
leonardo	ליונארדו
garner	גארנר
ballack	באלאק
rajoub	ר'גוב
deucalion	דוקאליון
pitts	פיטס
pele	פלה
bando	באנדו
pirlo	פירלו
nagano	נאגאנו
miriam	מיריאם
espoo	אספו
cornelius	קורניליוס
benghazi	בנגאזי
shaquille	שאקיל
ismail	אסמאעיל
dele	דילי
faure	פורי
temmu	טמו
kaebi	קעבי
lauper	לופר
chahine	שאהין
marois	מארוא
courtois	קורטוא
burgmeier	ברגמאיר
duscher	דושיר
sennett	סיניט
cobain	קוביין
zwartkruis	זוארטקרויס
galasek	גאלאסיק
sidorenko	סאידורניקו
morell	מוריל
mikel	מיקל
costacurta	קוסטאקורטא
packie	פאקי
ramzy	רמזי
gaafar	ג'עפר
mcclair	מקליר
janovic	יאנוביטש
dujkovic	דויקוביטש
marsden	מארסדן
panucci	פאנוצ'י
courtney	קורטני
hebuterne	אבוטארן
busch	בוש
ramzi	רמזי
tuncay	טונקיי
clifford	קליפורד
malevich	מאליביטש
illinois	אילינוי
duff	דאף
tranquillo	טראנקוילו
suharto	סוהארטו
heydar	חאידר
mondrian	מונדריאן
monge	מונג
osment	אוסמנט
korkmaz	קורקמאז
khamtai	חאמטאי
yamin	ימין
obama	אובאמא
coupet	קופה
taipei	טאיפיי
newtown	ניוטאון
sadir	סדיר
sherman	שרמאן
scarlatti	סקארלאטי
stanford	סטאנפורד
adolphe	אדולף
titta	טיטא
lindh	לינד
montcourt	מונטקורט
makinwa	מאקינוא
brooklyn	ברוקלין
linda	לינדא
cockburn	קוקבורן
farkash	פארקאש
patterson	פאטירסון
wood	ווד
laheeb	להיב
chisholm	צ'ישולם
carteron	קארטירון
soufiane	סופיאן
bettini	ביטיני
ryoichi	ריוצ'י
bosacki	בוסאצקי
radio	ראדיו
hantuchova	האנטשובא
carle	קארל
hassan	חסן
latins	לאטינז
cimabue	צ'ימאבו
carlo	קארלו
hogan	הוגאן
constantine	קונסטאנטין
benko	בינקו
barrymore	בארימור
lahore	לאהור
ruffalo	רופאלו
schweinsteiger	שבאינשטאיגר
zat	זאט
bacau	באקאו
pat	פאט
sankara	סאנקארא
rat	ראט
wat	ואט
hat	האט
kaladze	קאלאדזה
devon	דיבון
nat	נאט
six	סיקס
cat	קט
bizimungu	ביזימונגו
ribbeck	ריביק
shaqaqi	שקאקי
batta	באטא
kijuro	קיג'ורו
schwartzmann	שוארצמאן
peru	פירו
djakpa	ג'אפקא
dix	דיקס
rizwan	ריזואן
edmond	אדמונד
fisk	פיסק
marcel	מארסל
chulapa	צ'ולאפא
yamamoto	יאמאמוטו
gates	גייטס
amman	עמאן
ammar	עמאר
branduardi	בראנדוארדי
shwikar	שויקאר
seymour	סימור
baudrillard	באודרילארד
christopher	קריסטופר
theseus	תיסיוס
mendeleev	מנדלייב
yaghi	יאגי
dmitriyev	דמיטרייב
witte	ויט
natanz	נאטאנז
shih	שיה
metgod	מיטגוד
kahwaji	קהווג'י
freier	פרייר
litzman	ליצמאן
maldives	מאלדאיבז
stepanek	סטיפאניק
chiesa	קייזא
libor	ליבור
deripaska	דיריפאסקא
cetin	ג'טין
celan	צלאן
sassi	סאסי
sedki	סדקי
bellugi	בלוגי
fae	פיי
