ABBAGNANO	アバニャーノ
ABBO	アボウ
ABDERHALDEN	アプデルハルデン
ABEEL	アビール
ABERCROMBY	アバクロンビ
ABRAMS	エイブラムス
ACKLAND	アクランド
ADAK	アダック
ADAMUS	アダムス
ADDAMS	アダムズ
ADDINGTON	アディントン
ADELAIDE	アデレード
ADELMAN	エーデルマン
ADEMA	アデマ
ADER	アーダー
ADIL	アディル
ADORNO	アドルノ
AFGHANISTAN	アフガニスタン
AGOP	アゴップ
AGUESSEAU	アゲソー
AHMAD	アハマット
AILEEN	アイリーン
AJDUKIEWICZ	アジュキエウィッツ
ALAMEDA	アラメダ
ALASKA	アラスカ
ALBANO	オルバノ
ALBANY	アルバニ
ALECSANDRI	アレクサンドリ
ALEKSANDER	アレクサンデル
ALEKSANDR	アレクサンドル
ALEXANDROV	アレクサンドロフ
ALEXIS	アレクシス
ALFONZO	アルフォンソ
ALHADEFF	アルハデフ
ALIKHANOV	アリハーノフ
ALKEN	アルケン
ALLAIN	アラン
ALLARDYCE	アラダイス
ALMAGIA	アルマジア
ALPERT	アルパート
ALPHONSE	アルフォンス
ALTHEIM	アルトハイム
ALTMANN	アルトマン
ALTON	オールトン
ALVEAR	アルベアル
AMAN	アマン
AMBER	アンバー
AMBROSE	アンブローズ
AMIL	アミル
AMMANN	アンマン
AMMONS	アモンズ
ANATOLY	アナトリー
ANDALUSIA	アンダルシア
ANDERER	アンドラ
ANDERSEN	アンデルセン
ANDERSON	アンダースン
ANDOVER	アンドーバー
ANDREAE	アンドレー
ANET	アネ
ANGARA	アンガラ
ANGELOU	アンジェロウ
ANSELMO	アンセルモ
ANSERMET	アンセルメ
ANTHES	アンテス
ANTIMONY	アンチモン
ANUCHIN	アヌーチン
APOLLO	アポロ
APPIGNANESI	アッピグナネッセイ
ARBER	アルバー
ARCA	アーカ
ARCE	アルセ
ARCH	アーチ
ARDENNE	アルデンネ
ARDIGO	アルディゴ
ARETIN	アレティン
ARGENTA	アルヘンタ
ARI	アリ
ARIE	アリー
ARIEL	アリエル
ARKADY	アルカジイ
ARLINGTON	アーリントン
ARSEN	アルセン
ARTAMONOV	アルタモーノフ
ASA	アサ
ASCIOLLA	アショルラ
ASHCROFT	アッシュクロフト
ASHGABAT	アシガバット
ASHKENAZY	アシュケナージ
ASHWORTH	アシュウォース
ASSAD	アサド
ASTURIAS	アスツリアス
ATAL	アタル
ATALAY	アタライ
ATAMANOV	アタマノフ
ATHOS	エイソス
ATLANTA	アトランタ
ATLANTOV	アトラントフ
AUBERT	オベール
AUBREY	オーブリー
AUER	オーア
AUGUST	オーガスト
AUGUSTA	アウグスタ
AUKRUST	アウクルスト
AUREN	オーレン
AURISPA	アウリスパ
AUWERS	アウベルス
AXELSON	アクセルソン
AYO	アーヨ
AZNAVOUR	アズナブール
BAAL	バール
BACCELLI	バチェリ
BADGER	バジャー
BADLEY	バドレー
BADNER	バードナー
BAILLIE	ベーリー
BAKERSFIELD	ベーカーズフィールド
BAKLANOV	バクラノフ
BAKSHI	バクシ
BALCH	ボルチ
BALDUCCI	バルドゥッチ
BALDUNG	バルドゥング
BALEN	バーレン
BALENCIAGA	バレンシアガ
BALES	ベールズ
BALIN	バラン
BALLA	バルラ
BALLY	バイイ
BALMAIN	バルメイン
BALSAS	バルサ
BAMPTON	バンプトン
BANERJI	バナージ
BANNISTER	バニスター
BANTING	バンティング
BARANSON	バランソン
BARBAULD	バーボールド
BARDA	バルダ
BARENTS	バレンツ
BARKLEY	バークリ
BARKSDALE	バークスデール
BARLETT	バーレット
BARNARD	バーナード
BARRETTO	バレット
BARTOLI	バルトーリ
BARTOLOMMEO	バルトロメオ
BASCH	バッシュ
BASCHWITZ	バシュビツ
BASIL	バジル
BASSA	バッサ
BASSET	バセ
BAST	バースト
BATEMAN	ベイトマン
BATUR	バトゥル
BAUCUS	ボーカス
BAUGIN	ボージャン
BAUMAN	バウマン
BAUSCH	バウシュ
BAVADRA	ババンドラ
BAX	バックス
BAYES	ベーズ
BAYLOR	ベイラー
BAYLY	ベイリー
BAZILEVICH	バジレービッチ
BAZLEY	バズレイ
BEAN	ビーン
BEATON	ビートゥン
BEATTIE	ビーティー
BEAUHARNAIS	ボーアルネ
BEAUSSANT	ボーサン
BECCAFUMI	ベッカフーミ
BECHI	ベーキ
BECHTEL	ベヒテル
BECHTLER	ベヒトラー
BECK	ベック
BECKENBAUER	ベッケンバウアー
BECKNELL	ベックネル
BEERS	ビーアズ
BEGONA	ベゴーニャ
BEHESHTI	ベヘシュチ
BEILENSON	ベイレンソン
BELGRADE	ベルグラード
BELLA	ベラ
BELLENGER	ベランジェ
BELLEZZA	ベルレッツァ
BELLINSGAUZEN	ベリンスガウゼン
BELLMAN	ベルマン
BELOUSOV	ベロウーソフ
BELYAEV	ベリャーエフ
BENEDEK	ベイネデク
BENGHAZI	ベンガジ
BENGT	ベングト
BENKENDORF	ベンケンドルフ
BENNY	ベニー
BENTSEN	ベンツェン
BERCHTOLD	ベルヒトルト
BERGELL	バーゲル
BERGSMA	ブルフスマ
BERGSTEDT	ベルグステット
BERKLEY	バークリー
BERMAN	ベルマン
BERNARD	ベルナール
BERNARDO	バーナード
BERNARI	ベルナーリ
BERNBACHER	ベルンバッヒャー
BERNHART	バーンハート
BERTI	ベルティ
BERTILLON	ベルティヨン
BESNARD	ベナール
BESSET	ベセ
BESSIE	ベッシー
BESSON	ベッソン
BETJEMAN	ベチェマン
BETSY	ベツィー
BEUS	ベウス
BEZOBRAZOV	ベゾブラーゾフ
BEZOLD	ベーツォルト
BEZZENBERGER	ベッツェンベルガー
BIENVILLE	ビヤンビル
BIERMANN	ビーアマン
BIGNONE	ビニョーネ
BIK	ビク
BILLETDOUX	ビエドゥ
BILLINGTON	ビリントン
BINCHOIS	バンショア
BIRBAL	ビールバル
BIRGER	ビルゲル
BIRGITTA	ビルギッタ
BISCHOF	ビショフ
BISKUP	ビスクープ
BIVONA	ビボナ
BJERRE	ビェール
BJERRUM	ビエルム
BJORNVIG	ビョルンビー
BLACKETT	ブラケット
BLACKMAN	ブラックマン
BLACKWOOD	ブラックウッド
BLADEN	ブレーデン
BLAIN	ブラン
BLAKELOCK	ブレークロック
BLALOCK	ブレーロック
BLANCH	ブランチ
BLANPAIN	ブランパン
BLASETTI	ブラゼッティ
BLATT	ブラット
BLINDER	ブラインダー
BLITZSTEIN	ブリッツスタイン
BLOKHINTSEV	ブローヒンツェフ
BLOM	ブルム
BLOMBERG	ブロムベルイ
BLOUNT	ブラウント
BLYSTONE	ブライストーン
BODDY	ボディー
BOEKE	ベーケ
BOGDANOFF	ボグダノフ
BOGORODSKY	ボゴロドスキー
BOISSEVAIN	ボワセベン
BOK	ボック
BOLINGER	ボーリンジャー
BONAPARTE	ボナパルト
BONDS	ボンズ
BONE	ボーン
BONFA	ボンファ
BONGO	ボンゴ
BONILLA	ボニーヤ
BONINSEGNA	ボニンセーニャ
BONNOME	ボノム
BOORSTIN	ブーアスティン
BORELLI	ボレリ
BORGATTI	ボルガッティ
BORGHINI	ボルギーニ
BORGNINE	ボーグナイン
BORGOGNONE	ボルゴニョーネ
BORJA	ボルハ
BORNSTEIN	ボーンスタイン
BORROW	ボロー
BOSE	ボース
BOSETTI	ボセッティ
BOSKO	ボスコ
BOSSERT	ボッセルト
BOSWORTH	ボズワース
BOUGAINVILLE	ブーゲンビル
BOUMAN	バウマン
BOUQUET	ブーケ
BOURIN	ブーラン
BOURRIENNE	ブーリエンヌ
BOUVET	ブーベ
BOWRING	バウリング
BOY	ボイ
BOYCE	ボイス
BOYNTON	ボイントン
BRAATOY	プラトイ
BRACKENRIDGE	ブラッケンリッジ
BRADMAN	ブラッドマン
BRANDIS	ブランディス
BRANSTON	ブランストン
BRATTELI	ブラッテリ
BRAY	ブレー
BREAM	ブリーム
BRENNEIS	ブレンナイス
BRET	ブレ
BRETSCHNEIDER	ブレートシュナイダー
BREZHNEV	ブレジネフ
BRICE	ブライス
BRIDIE	ブライディ
BRIEFS	ブリーフス
BRIGITTE	ブリギッテ
BRILLANTES	ブリヤンテス
BRINELL	ブリネル
BRISCOE	ブリスコー
BROCH	ブロック
BROCHARD	ブロシャール
BRODERICK	ブロデリック
BROWNLOW	ブラウンロー
BROWNSTEIN	ブラウンスタイン
BRUNE	ブリュヌ
BRUNSCHWIG	ブルンシュウィク
BRUNTON	ブラントン
BRYCE	ブライス
BUCHAN	バカン
BUCHERER	ブーヘラー
BUCKINGHAMSHIRE	バッキンガムシャー
BUECHNER	ブッヒュナー
BUFF	ブフ
BUISSON	ビュイソン
BURBAGE	バーベッジ
BURGHARDT	バーグハート
BURGHAUSER	ブルクハウザー
BURKHARD	ブルクハルト
BURLEIGH	バーリー
BURMA	ビルマ
BURMAN	バーマン
BURNAM	バーナム
BURNETT	バーネット
BUSHMAN	ブッシュマン
BUSKIRK	バスカーク
BUSWELL	バズウェル
BUXBAUM	ブックスバウム
BYLAND	バイランド
CADILLAC	キャデラック
CADIZ	カディス
CAHN	カーン
CAILLARD	カイヤール
CALABRESE	カラブレーゼ
CALAME	カラム
CALDERON	カルデロン
CALDERWOOD	コールダウッド
CALGARY	カルガリー
CALLEJAS	カジェハス
CALMER	カーマー
CALMES	カルマス
CALVINO	カルビーノ
CAMBEFORT	カンプフォール
CAMBRELING	カンブルラン
CAMEROON	カメルーン
CAMPAN	カンパン
CAMPIN	カンピン
CAMPS	キャン
CAMY	キャミー
CANAN	キャノン
CANBERRA	キャンベラ
CANTOR	カンター
CAPELLE	カペレ
CAPITANI	カピターニ
CAPITANT	カピタン
CAPOLONGO	カポロンゴ
CAPPIELLO	カピエロ
CAPPUCCILLI	カップッチルリ
CAPRA	キャプラ
CAPRI	カプリ
CARD	カード
CARDIFF	カーディフ
CARDINE	カルディーヌ
CARIBOU	カリブー
CARLES	カルレス
CARMEL	カルメル
CARNES	カーンズ
CAROLA	カローラ
CARRINGTON	カーリントン
CARROTHERS	カロゾルス
CARY	キャリー
CASANOVA	カザノーバ
CASELLATO	カゼルラート
CASELLI	カセリ
CASH	キャッシュ
CASSATT	カサット
CASTELLO	カステロ
CASTILLO	カスティヨ
CASTRIES	カストリーズ
CATHCART	キャスカート
CATILINA	カティリナ
CAULEY	コーリー
CAXIAS	カシアス
CAY	ケイ
CELASUN	ジェラスン
CENNINI	チェンニーニ
CERAM	ツェーラム
CERMAK	サーマク
CERRUTI	セルッティ
CESAR	シーザー
CHABON	シェイボン
CHABRIER	シャブリエ
CHAISSON	チェイソン
CHAKRAVARTI	チョクロボルティー
CHALABALA	ハラバラ
CHALANDON	シャランドン
CHALUMEAU	シャリュモー
CHAMBERLIN	チェンバリン
CHAMBERS	チェンバーズ
CHAMPOLLION	シャンポリオン
CHAN	チャン
CHANDERNAGOR	シャンデルナゴール
CHANDOR	チャンダー
CHANDRA	チャンドラ
CHAPPELL	チャッペル
CHARDONNET	シャルドンネ
CHARIS	ハーリス
CHARLOT	シャロー
CHARVIN	シャルバン
CHASE	チェイス
CHATFIELD	チャトフィールド
CHATTANOOGA	チャタヌーガ
CHAULET	ショレー
CHAUTEMPS	ショータン
CHEKHOV	チェーホフ
CHEMNITZ	ケムニッツ
CHEVALLEY	シュバレー
CHEVENEMENT	シュベーヌマン
CHIAPELLI	キャペリ
CHICHESTER	チチェスター
CHICKEN	チキン
CHIESA	キエザ
CHILLINGWORTH	チリングワース
CHILTON	チルトン
CHIN	チン
CHODOS	チョドス
CHOQUET	ショケー
CHRISTINA	クリスティーナ
CHRISTOFFERSEN	クリストファーソン
CHRISTOPHERSEN	クリストファセン
CHUIKOV	チュイコフ
CHURCHILL	チャーチル
CIAMPI	シャンピ
CIGADA	チガーダ
CIMINO	シミノ
CIRIACO	チリアコ
CLAES	クラース
CLAPP	クラップ
CLARICE	クラリッセ
CLAVIUS	クラビウス
CLAYTON	クレイトン
CLEMENTE	クレメンテ
CLEMENTIS	クレメンティス
CLERMONT-FERRAND	クレルモンフェラン
CLIFF	クリフ
CLISSOLD	クリソルド
COBO	コボ
COLDEN	コールデン
COLERIDGE	コールリッジ
COLUCCIO	コルッチョ
COMOLLI	コモリ
CONCHON	コンション
CONINXLOO	コニンクスロー
CONN	コーン
CONNAUGHT	コンノート
CONNELLAN	コネラン
CONNOR	コナー
CONRADY	コンラディ
CONSTANTINO	コンスタンチノ
CONSTANTINOS	コンスタンチノス
CONTI	コンチ
CONWELL	コンウェル
COOLIDGE	クーリッジ
COON	クーン
COPELAND	コープランド
COPPEL	コッペル
CORAM	コーラム
CORAZZA	コラザ
CORBOZ	コルボ
CORNELISZ	コルネーリス
CORNWELL	コーンウェル
CORRADI	コラーディ
CORRAL	コラール
CORTONA	コルトーナ
COSSU	コッス
COULTON	コールタン
COURNOT	クールノ
COURTRAI	クルトレ
COUSTOU	クストゥ
COX	コックス
COYSEVOX	コアズボ
CRACKNELL	クラックネル
CREIZENACH	クライゼナハ
CREMIN	クレメン
CRISTINA	クリスティーナ
CRISWELL	クリスウェル
CROXTON	クロックストン
CSOKOR	チョコル
CUDWORTH	カドワース
CUMMING	カミング
CUMMINS	カミンズ
CUNNINGHAM	カニングハム
CUOMO	クオモ
CUREL	キュレル
CURLEY	カーリー
CVETKO	ツベトコ
CYNTHIA	シンシア
CZERWINSKI	ザウインスキー
CZOLBE	ツォルベ
DACH	ダッハ
DACHAU	ダハウ
DAHLANDER	ダランダー
DAHMER	ダーマ
DALEY	デイリー
DAM	ダム
DAMPIER	ダンピア
DAN	ダン
DANCOURT	ダンクール
DANIELSSON	ダニエルソン
DANILOFF	ダニロフ
DANNEMANN	ダンネマン
DANOV	ダノフ
DARLING	ダーリン
DARMSTADT	ダルムシュタット
DART	ダート
DARTMOUTH	ダートマス
DASSAULT	ダッソー
DAUBENTON	ドーバントン
DAUBER	ドーバー
DAUMIER	ドーミエ
DAUTHENDEY	ダウテンダイ
DAVES	デイブズ
DAVIDOVIC	ダビドビチ
DAVIDOW	ダビドウ
DAVIDS	デービズ
DEBS	デブス
DEBUSSY	ドビュッシー
DECKER	デッカー
DEEMS	ディームズ
DEKKER	デッカー
DELAWARE	デラウェア
DELIUS	デリアス
DELOGU	デローグ
DELTA	デルタ
DEMETZ	ドゥメッツ
DEMIDOVA	デミードワ
DEMUS	デームス
DENNER	デンナー
DENNIN	デニン
DENNISON	デニスン
DENON	デノン
DENT	デント
DEPEW	デピュー
DERLETH	ダーレス
DERNBURG	ダンバーク
DERRICK	デリック
DERTINGER	デルティンガー
DERWINSKI	ダーウィンスキー
DESCOMBES	デコンブ
DESMOULINS	デムーラン
DESNOS	デスノス
DESTLER	デスラー
DESVIGNES	デスバイン
DETERDING	デターディング
DEVANEY	デバネー
DEVONSHIRE	デボンシャー
DEWEY	デューイ
DIAL	ダイアル
DICK	ディック
DICKSON	ディクソン
DIEM	ディーム
DIENER	ディーナー
DIEUPART	デュパール
DILLARD	ディラード
DIMITROV	ディミトロフ
DINAN	ダイナン
DINWIDDIE	ディンウィディー
DIOUF	ディウフ
DIRKSEN	ダークセン
DITTMAN	ディットマン
DJAKARTA	ジャカルタ
DLAMINI	ラミニ
DOBRODINSKY	ドブロジンスキー
DOD	ドッド
DODOMA	ドドマ
DOHA	ドーハ
DOHERTY	ドーアティ
DOLGUN	ドルガン
DOLLAR	ダラー
DOMINGUEZ	ドミンゲス
DOMINICK	ドミニク
DOMINIQUE	ドミニーク
DONATI	ドナティ
DONNA	ドナ
DONNAN	ドナン
DONNAY	ドネー
DONNER	ドナー
DOOLITTLE	ドリトル
DORCHESTER	ドーチェスター
DORF	ドルフ
DOXIADIS	ドクシアディス
DOZY	ドージ
DRAGO	ドラゴ
DREIER	ドライア
DREVER	ドゥリーバー
DROR	ドロール
DUBININ	ドゥビーニン
DUBROVNIK	ドブロブニク
DUDOK	デュドック
DUKES	デュークス
DUMBADZE	ドムバーゼ
DUMITRU	ドミトル
DUMOUCHEL	デュムシェル
DUNCAN	ダンカン
DUNDEE	ダンディー
DUNNIGAN	ダニガン
DUNSANY	ダンセイニ
DUNSTAN	ダンスタン
DURAN	デュラン
DURANTE	ドゥランテ
DURKHEIM	デュルケーム
DUROV	ドゥーロフ
DUTSCHKE	ドゥチケ
DUVAL	デュバル
DUVERGER	デュベルジェ
EAGER	イーガー
EARLY	アーリー
EASON	イーソン
EASSON	エアッソン
EAST	イースト
EATON	イートン
EBBESEN	イブセン
EBBINGHAUS	エビングハウス
EBERLE	エバリー
EBHARDT	エープハルト
ECO	エーコ
EDINGER	エディンガー
EDITA	エディタ
EDMUND	エトムント
EECKHOUT	エークハウト
EFIMENKO	エフィメンコ
EGGAR	エガー
EGGERS	エッガース
EGILSSON	エギルソン
EHRHARDT	エールハルト
EHRLICHMAN	アーリックマン
EICHER	アイヒャー
EICHLER	アイヒラー
EICHNER	アイクナー
EINAR	エイナル
EINTHOVEN	アイントホーフェン
EISDORFER	アイスドーファー
EISENREICH	アイゼンライヒ
ELDER	エルダー
ELGART	エルガート
ELIJAH	エリヤ
ELLENBOGEN	エレンボーゲン
ELLIE	エリー
ELTINGE	エルティンジ
ELVEY	エルビ
ENDE	エンデ
ENGSTROM	エングストロム
ERDENE	エルデネ
ERFURT	エルフルト
ERLANDER	エルランデル
ERNESTI	エルネスティ
ERNESTINE	アーネスティン
ERVINE	アービン
ESPEJO	エスペホ
ESPERT	エスペル
ESPIN	エスピン
ESTER	エスター
ETHIOPIA	エチオピア
ETIENNE	エティエンヌ
EUCLID	ユークリッド
EUGEN	ユージン
EURICH	ユーリック
EVELINE	エブリン
EVERHART	エバーハート
EWELL	ユーエル
EYSER	エイゼル
EZER	エゼル
FABBRI	ファッブリ
FABIENNE	ファビェンヌ
FABIUNKE	ファビウンケ
FABRITIUS	ファブリティウス
FAGE	フェージ
FAIN	ファン
FAITH	フェイス
FAJANS	ファヤンス
FALIERI	ファリエーリ
FALKBERGET	ファルクベルゲ
FANTI	ファンティ
FARADAY	ファラデー
FARJEON	ファージョン
FARLOW	ファーロウ
FARMAN	ファルマン
FARMER	ファーマー
FARNESE	ファルネーゼ
FARNUM	ファーナム
FARRE	ファー
FARRINGTON	ファリントン
FATH	ファト
FAZAL	ファザール
FEDERN	フェダーン
FEDORCHENKO	フェドルチェンコ
FEDORENKO	フェドレンコ
FEELY	フィーリー
FEINHALS	ファインハルス
FELD	フェルド
FELLOWS	フェローズ
FELTIN	フェルタン
FENDLER	フェンドラー
FENNELLY	フェンリー
FENSKE	フェンスケ
FERDINAND	フェルディナンド
FERGER	フェルガー
FERNANDI	フェルナンディ
FERNBACH	ファーンバック
FERNEL	フェルネル
FERRARA	フェラーラ
FERRERO	フェレーロ
FERRINI	フェリーニ
FIEDLER	フィードラー
FIFER	ファイファー
FIGL	フィグル
FILAR	フィラール
FILDES	フィルデス
FILIPPESCHI	フィリッペスキ
FINDLAY	フィンドレー
FINE	ファイン
FINIGUERRA	フィニグエラ
FINK	フィンク
FINNEGAN	フィネガン
FIORI	フィオリ
FIRTH	ファース
FITELBERG	フィテルベルク
FITTS	フィッツ
FITZGIBBON	フィッツギボン
FITZWALTER	フィッツウォルター
FLACH	フラシュ
FLACK	フラック
FLAVIO	フラビオ
FLEMMING	フレミング
FLETCHER	フレッチャー
FLIPPO	フリッポ
FLORENCE	フロランス
FLORES	フローレス
FLORIDABLANCA	フロリダブランカ
FLORY	フローリー
FLOWER	フラワー
FLUSSER	フラッサー
FOCH	フォッシュ
FOCSA	フォクシャ
FOK	フォック
FOLDI	フォルディ
FOLZ	フォルツ
FOMIN	フォミーン
FOMINA	フォミーナ
FONVIZIN	フォンビージン
FOPPA	フォッパ
FORCADE	フォルカード
FORNER	フォーナー
FORSDYKE	フォースダイク
FORTES	フォルテス
FORTIER	フォティア
FORTUNATOV	フォルトゥナートフ
FOSSEY	フォセー
FOSSUM	フォサム
FOURCROY	フルクロア
FOURNET	フルネ
FOURNIER	フルニエ
FOY	フォア
FRAENKEL	フレンケル
FRAHM	フラーム
FRANCISCO	フランシスコ
FRANCKENSTEIN	フランケンシュタイン
FRANKENBURG	フランケンブルグ
FRANKENSTEIN	フランケンシュタイン
FRANKLIN	フランクリン
FRAPPIER	フラピエ
FREDDY	フレディ
FREDERICKSON	フレデリクソン
FREE	フリー
FREEMANTLE	フリーマントル
FRENZEL	フレンツェル
FRESNO	フレスノ
FRESSON	フレッソン
FRETWELL	フレットウェル
FREYE	フライ
FRIDAY	フライディ
FRIDMAN	フリドマン
FRIEDKIN	フリードキン
FRIEDLAENDER	フリートレンダー
FRIEND	フレンド
FRIMMER	フリマー
FRITJOF	フリッチョフ
FROBENIUS	フロベーニウス
FROBISHER	フロービシャー
FRUIN	フルーイン
FUGA	フーガ
FUGGER	フッガー
FUKA	フカ
FULDA	フルダ
FURRER	フラー
FUSSELL	ファッセル
GABIN	ギャバン
GABRIELLE	ガブリエル
GADZHIBEKOV	ガジベーコフ
GAGE	ゲイジ
GAHN	ガーン
GAIL	ゲール
GAIO	ガイオ
GAISFORD	ゲーズフォード
GALANTAY	ガランタイ
GALIN	ガーリン
GALLENGA	ガレンガ
GALLI	ガルリ
GAMBIA	ガンビア
GAMBKE	ガンプケ
GAMBOA	ガンボア
GANDY	ガンディー
GANZO	ガンゾ
GARBIN	ガルビン
GARBUZOV	ガルブーゾフ
GARDINI	ガルディーニ
GARFINKEL	ガーフィンケル
GARGIULO	ガルジューロ
GAROFALO	ガロファロ
GARTH	ガース
GARTON	ガートン
GATLING	ガトリング
GAUDRY	ゴードリー
GAUGUIN	ゴーガン
GAUSE	ゴース
GAUSS	ガウス
GAUTHIER	ゴーチエ
GAVSHON	ガブション
GEBAUER	ゲバウエル
GEDDES	ゲッデス
GEFFCKEN	ゲフケン
GEFFRARD	ジェフラール
GEFFROY	ジェフロア
GEIBEL	ガイベル
GELLERT	ゲラート
GELLY	ゲリー
GENSOUS	ジャンスース
GENTA	ジェンタ
GEOFFRAY	ジョフレ
GEORGINA	ジョージナ
GEORGIOS	ジョルジオ
GERSHWIN	ガーシュイン
GEVAERT	ジュバール
GIANNOTTI	ジャンノッティ
GIBBONS	ギボンズ
GIESE	ギーゼ
GIESEN	ギーゼン
GILLIS	ギリス
GILPIN	ギルピン
GINNER	ジンナー
GINZBOURG	ギンズブルグ
GIOVANINETTI	ジョバニネッティ
GIRISH	ギリッシュ
GIUSTI	ガスティ
GLACKENS	グラッケンズ
GLADDEN	グラッデン
GLADER	グレーダー
GLASS	グラース
GLAUBER	グラウバー
GLAZKOV	グラズコフ
GLEIM	グライム
GLINES	グラインズ
GLORIA	グロリア
GLOSSOP	グロッソップ
GLUCK	グルック
GMEINER	グマイナー
GOA	ゴア
GOBINEAU	ゴビノー
GODDARD	ゴダード
GODECHOT	ゴデショ
GOFMAN	ゴフマン
GOFORTH	ゴフォース
GOKEL	ゴケル
GOLA	ゴラ
GOLDONI	ゴルドーニ
GOLDSBROUGH	ゴールズブロ
GOLEIZOVSKY	ゴレイゾフスキー
GOODPASTER	グッドパスター
GOODRICH	グッドリッチ
GOODY	グディ
GOPAL	ゴパール
GORBACHEV	ゴルバチョフ
GORES	ゴアズ
GORMAN	ゴーマン
GOSSAGE	ゴセージ
GOTLIEB	ゴットリーブ
GOTOVAC	ゴトバツ
GOTTSCHALL	ゴットシャル
GOTTWALD	ゴットバルト
GOUDAREAU	グダロー
GOUGAUD	グゴー
GOUGH	ゴフ
GOULART	ゴラール
GOULD	グルード
GOURD	グール
GOURSAT	グルサ
GOWERS	ガワーズ
GOZMAN	ゴズマン
GRACCHUS	グラックス
GRAETZ	グレーツ
GRANBY	グランビー
GRATSIANOV	グラツィアノフ
GRATTAN	グラタン
GRECO	グレコ
GREDE	グレーデ
GREENMAN	グリーンマン
GREGOIRE	グレゴアール
GREITZER	グレイツァー
GRENADINES	グレナダショトウ
GRENARD	グルナール
GRENVILLE	グレンビル
GREVE	グリーブ
GRIFF	グリフ
GRIFFI	グリッフィ
GRILLO	グリロー
GRIMAULT	グリモー
GRINKER	グリンカー
GROBE	グローブ
GROGGER	グロッガー
GRONOV	グロノフ
GROOS	グロース
GROSSER	グロセール
GROSSETESTE	グローステスト
GROSVENOR	グローブナー
GRUELLE	グルーエル
GRUENTHER	グランサー
GRUPPE	グラップ
GUADALUPI	グアダルーピ
GUARESCHI	グァレスキ
GUARINI	グアリーニ
GUENTER	ギュンター
GUILLOT	ギヨ
GUIOT	ギオ
GULII	グーリィ
GULIN	グリン
GULLIN	グリン
GUMP	ガンプ
GUNDY	グンディ
GUNNAR	グンナー
GUNNEL	グンネル
GUPTILL	グプティル
GURLITT	グルリット
GUTFREUND	グットフロイント
GUTSTEIN	グートシュタイン
GUTTMAN	グットマン
GUTZEIT	グートツァイト
GWYN	グウィン
HAANPAA	ハーンパー
HAAS	アース
HABERMAS	ハーバーマス
HACKET	ハケット
HADLEY	ハドリー
HADLOCK	ハドロック
HAENISCH	ヘーニシュ
HAGEDORN	ハーゲドルン
HAGGARD	ハガード
HAIDINGER	ハイディンガー
HAIGHT	ヘイト
HAJDU	アイドゥー
HAKEN	ハーケン
HALE	ヘール
HALEM	ハレム
HALEY	ヘイリー
HALLDOR	ハルドール
HALPHEN	アルファン
HALSTED	ホールステッド
HAMLET	ハムレット
HAMMEN	ハーメン
HAMMOND	ハモンド
HAMP	アンプ
HAMPTON	ハンプトン
HANDKE	ハントケ
HANES	ヘインズ
HANEY	ヘイニー
HANNAFORD	ハナフォード
HANNAN	ハナン
HANNAY	ハネー
HANOI	ハノイ
HANSEN	ハンゼン
HAQ	ハク
HARALD	ハーラル
HARDOY	ハルドイ
HARRELL	ハレル
HARRIE	ハリー
HARRIGAN	ハリガン
HARRY	ハリー
HARTWIG	ハルトビヒ
HARVE	ハーブ
HARVEY	アルビー
HARVILL	ハービル
HASKELL	ハスケル
HASSAN	ハッサン
HASSANAL	ハッサナル
HATTON	ハットン
HAUDEBOURG	オードブール
HAWORTH	ハワース
HAX	ハックス
HAYES	ヘイズ
HAZARD	アザール
HAZLITT	ハズリット
HEBRA	ヘーブラ
HEDAYAT	ヘダーヤト
HEDDA	ヘッダ
HEHN	ヘーン
HEILMANN	ハイルマン
HEIMS	ハイムズ
HEINICKE	ハイニッケ
HEINRICH	ハインリッヒ
HEINZE	ハインゼ
HEISTER	ハイスター
HELGA	ヘルガ
HELLMAN	ヘルマン
HELMUT	ヘルムート
HELST	ヘルスト
HEMENWAY	ヘミンウェイ
HENCH	ヘンチ
HENCKELL	ヘンケル
HENNEQUIN	エヌカン
HENRICK	ヘンリック
HENSCHEL	ヘンシェル
HENSELT	ヘンゼルト
HENSEN	ヘンゼン
HEPBURN	ヘップバーン
HERBERT	ハーバート
HERBURGER	ヘルブルガー
HERDER	ヘルダー
HERDMAN	ハードマン
HEREN	ヘレン
HERFORD	ハーフォード
HERIOT	ヘリオット
HERM	ヘルム
HERNANDEZ	ヘルナンデス
HERON	ヘロン
HERPIN	エルパン
HERRHAUSEN	ヘルハウゼン
HERRICK	ヘーリック
HERRMANN	ハーマン
HERSEY	ハーシー
HERTA	ハータ
HERTH	ハース
HERVEY	ハーベイ
HESSEN	ヘッセン
HEYDT	ハイト
HIBBERT	ヒバート
HIGHMORE	ハイモア
HILDEBRAND	ヒルデブランド
HILLMAN	ヒルマン
HINMAN	ヒンマン
HITCHINGS	ヒッチングス
HLAVAC	ラバック
HOBBS	ホッブス
HOCHBERG	ホッホバーグ
HOCHMAN	ホックマン
HODGE	ホッジ
HODGSON	ホジソン
HODKINSON	ハドキンソン
HOECHSTETTER	ヘーヒシュテッター
HOEL	フール
HOELSCHER	ヘルシャー
HOENE	ヘーネ
HOFHAIMER	ホーフハイマー
HOLLES	ホリス
HOLLINGSWORTH	ホリングスワース
HOLMYARD	ホームヤード
HOLTZMAN	ホルツマン
HOLZMANN	ホルツマン
HOMER	ホーナー
HONDA	ホンダ
HONTER	ホンテル
HOPKIRK	ホップカーク
HORMAYR	ホールマイル
HORNAK	ホーナック
HORNIMAN	ホーニマン
HORROCKS	ホロックス
HORT	ホート
HOSTOS	オストス
HOTELLING	ホテリング
HOUGHTON	ホートン
HOVORA	オボラ
HOYLE	オイレ
HOYT	ホイテ
HRABAL	フラバル
HRISANIDE	フリサニデ
HRUSCHKA	フルシュカ
HUEBNER	ヒューブナー
HUISMAN	ユイスマン
HULSE	ハルス
HUMFREY	ハンフリー
HUMPHRIES	ハンフリーズ
HUNDESHAGEN	フンデスハーゲン
HUNDLEY	ハンドレイ
HUNKER	ハンカー
HURST	ハースト
HUSAINI	フサイニー
HUXLEY	ハクスリー
HUYGENS	ホイヘンス
HVOROV	フボロフ
HYER	ハイアー
HYMAN	ハイマン
IAVICOLI	イアビコリ
ICILIUS	イキリウス
IDA	イダ
IMBODEN	インボデン
IMMISCH	インミッシュ
IMMOOS	インモース
IMRU	イムル
INARDI	イナルディ
INBER	インベル
INCA	インカ
INCHBALD	インチボールド
INGEGNERI	インジェニエーリ
INGENIEROS	インヘニェーロス
INGHAM	インガム
INGLIS	イングリス
INO	イノ
IOAN	ヨアン
ION	イオン
IORGA	ヨルガ
IOSELIANI	イオセリアーニ
IRANI	イラニ
IRENA	イレーナ
IRONS	アイアンズ
IRONSIDE	アイアンサイド
ISAK	アイザック
IVAILO	イワイロ
IVANOVA	イワノワ
IVANOVSKI	イワノフスキー
JAAP	ヤープ
JABLONOWSKI	ヤブロノフスキー
JABLONSKI	ヤブオニスキ
JACCARD	ジャカール
JACK	ジャック
JACOB	ジャコブ
JACOBSON	ヤコブソン
JACOTOT	ジャコトー
JACOULET	ジャクレー
JADASSOHN	ヤーダスゾーン
JAFFE	ジャフェ
JAHN	ヤーン
JAKOBY	ヤコビ
JAMBYN	ジャムビン
JAMMES	ジャム
JAMSA	ジャムサ
JANKE	ヤンケ
JANKO	ヤンコー
JANOW	ジェイノー
JANSKY	ジャンスキー
JANSON	ヤンソン
JASON	ジェイスン
JAUBERT	ジョベール
JAVITS	ジャビッツ
JEANMAIRE	ジャンメール
JENIFER	ジェニファー
JEPSON	ジェプスン
JEREMY	ジェラミー
JERGER	イェルガー
JESS	ジェス
JESSIE	ジェシー
JOANNA	ジョアナ
JOBIM	ジョビン
JOCELYN	ジョセリン
JOCK	ジョック
JODELLE	ジョデル
JOEL	ジョエル
JOEST	ヨースト
JOHANN	ヨハン
JOHNEN	ヨーネン
JOHNNIE	ジョニイ
JOHNNY	ジョニー
JOHNSON	ジョンスン
JOHNSTONE	ジョンストン
JOHNSTOWN	ジョンズタウン
JOMMELLI	ヨメリ
JONASSON	ヨナッソン
JORIS	ヨーリス
JOSEF	ヨセフ
JOSLIN	ジョスリン
JOTUNI	ヨトゥニ
JOUBIN	ジュバン
JOURDAIN	ジュールデン
JOZEF	ヨゼフ
JUDD	ジャッド
JUDSON	ジャドソン
JUGLAR	ジュグラール
JUIN	ジュアン
JUNGWIRTH	ユンクビルト
JUNOT	ジュノー
KAGEN	カーゲン
KAHL	カール
KAHNWEILER	カーンワイラー
KAISER	カイザー
KAJANUS	カヤーヌス
KALEDIN	カレージン
KALEVI	カレビ
KALMUS	カルムス
KALNBERZIN	カルンベルジン
KAMAL	カマル
KAMINSKY	カミンスキー
KANE	ケイン
KANTROWITZ	カントロウィッツ
KAPPEL	カッペル
KARAL	カラル
KARANJA	カランジャ
KARDELJ	カルデリ
KARELIA	カレリア
KARLA	カーラ
KARLSRUHE	カールスルーエ
KARPECHENKO	カルペチェンコ
KARUBI	カルビー
KASEY	ケイシー
KASSIAN	カシアン
KATERINA	カテリーナ
KATHARINE	キャサリン
KATZ	カッツ
KATZMAN	カッツマン
KAVERIN	カベーリン
KAWAWA	カワワ
KAY	ケー
KEE	ケー
KEEGAN	キーガン
KEES	キース
KEINHORST	カインホルスト
KEINO	ケイノ
KELEMEN	ケレメン
KELLNER	ケルナー
KELVIN	ケルビン
KEMPIS	ケンピス
KENDREW	ケンドルー
KERSHAW	カーショー
KESWICK	ケズウィック
KHALATBARY	ハラットバリー
KHALIDI	ハリディ
KHARKOV	カーコフ
KHINCHIN	ヒンチン
KILBY	キルビー
KILDUFF	キルダフ
KINDER	キンドル
KINGDOM	キングダム
KINGSTOWN	キングスタウン
KIOWA	カイオワ
KITCHENER	キッチナー
KLAGENFURT	クラーゲンフルト
KLAUSNER	クラウスナー
KLEMM	クレム
KLEPP	クレップ
KLIMT	クリムト
KLONDIKE	クロンダイク
KNELLER	ネラー
KNOLL	ノル
KNOLLES	ノールズ
KNOTTS	ノッツ
KNYAZHNIN	クニャジニーン
KNYPHAUSEN	クニプハウゼン
KOCHAN	コーチャン
KOCK	コッホ
KOEGEL	ケーゲル
KOEN	クン
KOESTLER	ケストラー
KOLISKO	コリスコ
KONASHEVICH	コナシェビチ
KONETZNI	コネツニ
KONRATH	コンラート
KORCHIN	コーチン
KORGANOFF	コルガノフ
KOSAMBI	コーサンビー
KOSTIUK	コスチューク
KOVACIC	コバチッチ
KRAAYVANGER	クラーイファンガー
KRANTZ	クランツ
KRENTZ	クレンツ
KREPPEL	クレッペル
KREYSSIG	クロイシッヒ
KRIPPNER	クリップナー
KRIS	クリス
KRISTENSEN	クリステンセン
KRITZ	クリッツ
KRONASSER	クロナッサー
KRONENBERGER	クローネンバーガー
KROUPA	クロウパ
KROUSKY	クロウスキー
KRPAN	クルパン
KRUMBACHER	クルムバハー
KRUSE	クルーズ
KRZYSZTOF	クシシュトフ
KRZYWICKI	クシビツキ
KUCHTA	クフタ
KUHLAU	クーラウ
KULKA	クルカ
KUNIN	クーニン
KUPCHENKO	クープチェンコ
KUPPER	クッパー
KUROPATKIN	クロパトキン
KUSSER	クッサー
KUZMIN	クズミン
KUZNETSOV	クズネツォフ
KVARAN	クバラン
KYD	キッド
KYRGYZSTAN	キルギスタン
LABRIOLA	ラブリオーラ
LACHENBRUCH	ラッヘンブルック
LADAME	ラダム
LADD	ラッド
LAGE	ラージュ
LAMENNAIS	ラムネ
LAMERTON	ラマートン
LAMPEDUSA	ランペドゥーサ
LAMPLE	ランプル
LAMSZUS	ラムスツス
LANCIOTTI	ランチョッティ
LANDERS	ランダーズ
LANGENSCHEIDT	ランゲンシャイト
LANGEVIN	ランジュバン
LANGFORD	ランフォード
LANGHAM	ランガム
LANNERS	ラナーズ
LANSBURY	ランズベリー
LAPORTE	ラポルト
LAPPO	ラッポ
LAPRADE	ラプラード
LAPSLEY	ラプスリー
LARGE	ラージ
LASKY	ラスキー
LASSUS	ラシュス
LATHROP	ラスロップ
LAUBE	ラウベ
LAUENSTEIN	ラウエンスタイン
LAUPER	ローパー
LAUREL	ローレル
LAUTH	ラウト
LAVEN	レービン
LAXALT	ラクソルト
LAYNE	レイン
LAZO	ラゾー
LEABUA	レアブア
LEBON	ルボン
LECH	レフ
LEFFSON	レフソン
LEHRNDORFER	レールンドルファー
LEHTONEN	レヒトネン
LEINSDORF	ラインスドルフ
LEIPOLD	ライポルト
LELY	レーリー
LEMNITZ	レムニツ
LENDVAY	レンドビー
LENGBORN	レングボルン
LEONARDO	レオナルド
LEONOR	レオノール
LERSCH	レルシュ
LESHAN	ルシャン
LEVANT	レバント
LEVI	レビ
LEVINGER	レビンガー
LEYDEN	レイデン
LIAM	リーアム
LIBERATORE	リベラトーレ
LIEBER	リーバー
LIEM	リーム
LIGNEUL	リギョール
LIKERT	リッカート
LILLEY	リリー
LILOV	リロフ
LINACRE	リナカー
LINCOLN	リンカーン
LINDEN	リンデン
LINE	リーヌ
LINGARD	リンガード
LINGE	リンゲ
LINKLATER	リンクレーター
LIPPI	リッピ
LIPSKY	リプスキー
LITT	リット
LITVIN	リトビン
LIVERMORE	リバモア
LIVESEY	リブジー
LIYONG	リオング
LOBE	ローベ
LODGE	ロッジ
LOHMEYER	ローマイアー
LOMBARDI	ロンバルジ
LONGANESI	ロンガネージ
LONGFELLOW	ロングフェロー
LOON	ローン
LORD	ロード
LORENTZ	ローレンツ
LOTTO	ロット
LOVEGROVE	ラブグローブ
LOWELL	ローエル
LOWENBERG	ローエンバーグ
LOWER	ロウアー
LOYD	ロイド
LOYONNET	ロアイヨンネ
LUBOWSKI	ルボウスキー
LUGOSI	ルゴシ
LUKE	ルーク
LUNELLI	ルネルリ
LUYTEN	ルイテン
LYBECK	リーベック
LYDGATE	リドゲート
LYELL	ライエル
LYMPANY	リンパニー
LYNDA	リンダ
LYNN	リン
LYSENKO	ルイセンコ
LYTE	ライト
LYTTON	リットン
MACDONOUGH	マクドナー
MACELWANE	マケルウェーン
MACGOWAN	マガウアン
MACHATY	マハティ
MACLAURIN	マクローリン
MACLAY	マクレー
MACLEAN	マクリーン
MACMILLAN	マクミラン
MACON	メーコン
MACY	メーシー
MADELEINE	マデライン
MADRID	マドリード
MAERKER	メーカー
MAFFEI	マッフェイ
MAGNES	マグニス
MAHLBERG	マールベルク
MAHLER	マーラ
MAHMOOD	マフモード
MAIMBOURG	マンブール
MAINE	メーン
MAIRET	メレ
MAIWANDWAL	マイワンドワル
MAKARENKO	マカーレンコ
MALANOWSKI	マラノフスキ
MALAWI	マラウイ
MALENOTTI	マレノッティ
MALLINSON	マリンソン
MALUS	マリュス
MANDEAU	マンドー
MANDEL	マンデル
MANET	マネ
MANGUIN	マンギャン
MANIU	マニウ
MANNONI	マノニ
MANSFELD	マンスフェルト
MANSTEIN	マンシュタイン
MANTUA	マントバ
MANUILA	マヌイラ
MANZONI	マンツォーニ
MAPU	マプー
MARABLE	マラブル
MARAGLIANO	マラリャーノ
MARANGONI	マランゴーニ
MARCHANT	マーチャント
MARCHESE	マルケーゼ
MARCIANO	マルチャノ
MARGARITIS	マルガリティス
MARGOTTA	マルゴッタ
MARIA	マリア
MARIJA	マリヤ
MARIMPIETRI	マリンピエトリ
MARK	マーク
MARKOS	マルコス
MARKOV	マルコフ
MARKOWITZ	マーコウィッツ
MARKSTEIN	マークスタイン
MARMION	マルミオン
MAROTO	マロート
MARRINER	マリナー
MARTENS	マールテンス
MARTI	マルティ
MARTINON	マルティノン
MARTINSON	マルティンソン
MASSOUDI	マスウーディー
MATA	マータ
MATAMOROS	マタモロス
MATT	マット
MATTA	マッタ
MATTHEW	マシュー
MATTSSON	マッツソン
MATZA	マッツァ
MAUDE	モード
MAUPEOU	モープー
MAURANE	モラーヌ
MAUSS	モース
MAUVE	モーブ
MAXIMILIAN	マクシミリアン
MAXINE	マキシン
MAXWELL	マックスウェル
MAYES	メイズ
MAZURA	マツーラ
MAZURKEVICH	マズルケビチ
MBABANE	ムババーネ
MBOYA	ムボヤ
MCGHEE	マッギー
MCKIBBEN	マッキベン
MCKINNON	マッキノン
MCLAREN	マクラーレン
MCNAUGHT	マクノート
MEAD	ミード
MEDILL	メディル
MEDINA	メディナ
MEDVED	メドベジ
MEDVEDEV	メドベジェフ
MEDVEDKIN	メドベートキン
MEGGERS	メガーズ
MEIGS	メグス
MEINONG	マイノング
MELMUKA	メルムカ
MENASHE	メナシェ
MENCL	メルツル
MENDELSOHN	メンデルゾーン
MENDENHALL	メンデンホール
MENDES	メンデス
MEREDITH	メレディス
MERI	メリ
MERING	メーリング
MERRIMAN	メリマン
MERZ	メルツ
MESSIER	メシエ
METHUEN	メスエン
MEVISSEN	メビッセン
MEYERBEER	マイアーベーア
MICHIGAN	ミシガン
MICK	ミック
MICOMBERO	ミコンベロ
MIDDLESEX	ミドルセックス
MIES	ミース
MIGNON	ミニョン
MIGRANYAN	ミグラニャン
MIKHALKOV	ミハルコフ
MIKUNIS	ミクニス
MILDRED	ミルドレッド
MILJAKOVIC	ミリャコビチ
MILLAY	ミレー
MILLIGAN	ミリガン
MILOS	ミロシュ
MILOVAN	ミロバン
MILT	ミルト
MINKOWSKI	ミンコフスキー
MINNIE	ミニー
MINOU	ミヌー
MINTZ	ミンツ
MIRONOV	ミロノフ
MIROSHNICHENKO	ミロシニチェンコ
MIRRA	ミラ
MISCHNICK	ミシュニク
MITROPOULOS	ミトロプーロス
MIURA	ミウラ
MIXON	ミクスン
MIZELL	ミゼル
MODENESE	モデネーゼ
MOGENSEN	モーエセン
MOHRING	モーリング
MOHSEN	モホセン
MOIR	モワール
MOISE	モイーズ
MOLENAER	モレナール
MOLINARO	モリナロ
MOLINO	モリーノ
MOLLY	モーリ
MOLTENI	モルテーニ
MONAGAS	モナガス
MONDOR	モンドール
MONETA	モネータ
MONICELLI	モニチェリ
MONIGETTI	モニゲッティ
MONNET	モネ
MONROE	モンロー
MONTAGU	モンタギュー
MONTAPERTO	モンタペルト
MONTEFUSCO	モンテフスコ
MONTEITH	モンティス
MONTELIUS	モンテリウス
MONTICELLI	モンティセリ
MONTYON	モンティヨン
MOODY	ムーディ
MOORCROFT	モーアクロフト
MOORHOUSE	ムアハウス
MORELLET	モルレ
MORET	モレト
MORI	モリ
MORLEY	モーリー
MORLOTTI	モルロッティ
MOROSINI	モロシーニ
MORTLOCK	マートロック
MOSTAERT	モステール
MOSTAR	モスタル
MOSTRAS	モストラス
MOTT	モット
MOTTEVILLE	モットビル
MOUDUD	モウドド
MOUNT	マウント
MOUSSY	ムーシー
MOWRER	マウラー
MOZHAEV	モジャーエフ
MUGGERIDGE	マガリッジ
MUHLER	ムーラー
MUKERJEE	ムケルジー
MUN	マン
MUNCH	ムンク
MUNDAY	マンデー
MUNGER	ミュンガー
MUNRO	マンロー
MUNSEL	マンゼル
MUNTEANU	ムンテアーヌ
MURALT	ムラルト
MURANYI	ムレイニー
MURDOCK	マードック
MURGER	ミュルジェール
MURNAU	ムルナウ
MURRAY	マリイ
MUSA	ムーサー
MUSATOV	ムサートフ
MUSCETTA	ムシェッタ
MUSEBENI	ムセベニ
MUSGRAVE	ムスグレーブ
MUSSCHENBROEK	ミュッセンブルーク
MUSULIN	ムスリン
MUTCH	マッチ
MYBURGH	マイバラー
MYER	マイヤー
NABI	ナビ
NADLER	ナードラー
NAGEL	ネーゲル
NAHM	ナム
NAIDOO	ナイドウ
NAJMABADI	ナジマバーディ
NAKHIMOV	ナヒーモフ
NANINO	ナニーノ
NAPIER	ネピア
NAPLES	ナポリ
NAPOLES	ナポレス
NAREZHNYI	ナレージヌイ
NASIR	ナーシル
NASON	ネイスン
NASSIRI	ナスィーリー
NAT	ナット
NECKE	ネッケ
NECKER	ネッケル
NEGREIROS	ネグレイロ
NEGRONI	ネグローニ
NEILSON	ニールソン
NEMCHINOV	ネムチーノフ
NEMESHEGYI	ネメシェギ
NENOV	ネノフ
NEPIL	ネピル
NESIN	ネシン
NETTELS	ネッテルズ
NEUKIRCH	ノイキルヒ
NEWCOMBE	ニューカム
NEWLIN	ニューリン
NEYMAN	ネーマン
NICOLAS	ニコラス
NICOLAY	ニコレー
NICOLL	ニコル
NICOLLE	ニコル
NIEMELA	ニーメラ
NIEUWLAND	ニューランド
NIJMEGEN	ナイメーヘン
NIKIFOROVICH	ニキフォロビチ
NIKLAS	ニクラス
NIKOLAS	ニコラス
NIKULIN	ニクーリン
NISKANEN	ニスカネン
NISSEN	ニッセン
NKOMO	ヌコモ
NOBLE	ノーブル
NOCKER	ノッカー
NONET	ノネ
NORDBY	ノードバイ
NORDHAUS	ノードハウス
NORENA	ノレナ
NORIEGA	ノリエガ
NORTHUMBERLAND	ノーサンバーランド
NOURSE	ナース
NOVGOROD	ノブゴロド
NOVIKOV	ノビコフ
NOWACK	ノバック
NUFFIELD	ナフィールド
NURIEV	ヌーリェフ
NUTTALL	ナトール
NYBLAEUS	ニューブレイウス
NYSTEDT	ニーステット
O'HARA	オハラ
OASTLER	オーストラー
OBANDO	オバンド
OBERTH	オーベルト
ODELL	オーデル
ODEN	オーデン
ODESSA	オデッサ
ODHNER	オドナー
ODOM	オドム
OECOLAMPADIUS	エコランパディウス
OGG	オッグ
OGGIONO	オッジョーノ
OKER	オーケル
OLAF	オラーフ
OLDYS	オールディス
OLIVEIRA	オリベイラ
OLTMANS	オルトマンス
OMAN	オーマン
ORAISON	オレゾン
ORELLANA	オレリャナ
ORGA	オルガ
ORIANA	オリアーナ
ORIBE	オリベ
ORKUN	オルクン
OROFINO	オロフィーノ
ORTEGA	オルテガ
ORTIZ	オルティス
OSBORN	オズボーン
OSBORNE	オスボーン
OSCAR	オスカー
OSMOND	オズモンド
OSTEND	オーステンデ
OSTROM	オストローム
OSTROVITYANOV	オストロビチャーノフ
OTTAWA	オタワ
OUDINOT	ウーディノー
OULD	オールド
OUSELEY	ウーズリ
OXENHAM	オクセナム
OXLEY	オックスレー
PAARLBERG	パールバーグ
PACETTI	パチェッティ
PADMORE	パドモア
PAGE	パージュ
PAGET	パゼット
PAINE	ペイン
PAISII	パイシ
PAITA	パイタ
PALING	ペイリング
PALLA	パラ
PALLADINO	パラディーノ
PALLOL	パロール
PALUZZI	パルッツィ
PAM	パム
PANDO	パンド
PANDORA	パンドラ
PANFYOROV	パンフョーロフ
PANKRATOVA	パンクラートワ
PAOLINO	パオリーノ
PAPALEKSI	パパレークシ
PARKES	パークス
PARLY	パーリー
PARR	パー
PARRIS	パリス
PASCAN	パスツァン
PASCHE	パッシュ
PASERO	パゼロ
PASKEVICH	パスケービッチ
PASSEK	パセック
PASTORI	パストリ
PATE	ペート
PATEL	パテル
PATSALIDES	パツァリデス
PATTERSON	パタースン
PATTI	パティ
PATTIS	パッティス
PATTISON	パチソン
PAUCK	パウク
PAULSEN	パウルゼン
PAUNCEFOTE	ポーンスフト
PAVAUX	パボー
PEACH	ピーチ
PEAKE	ピーク
PECHNER	ペヒナー
PEDERZINI	ペデルツィーニ
PEERY	ピーリー
PEETERS	ペーテルス
PEEV	ペーエフ
PEIFFER	ペイフェール
PELCZYNSKI	ペルチンスキー
PELEGRIN	プレグラン
PELLETT	ペレット
PELLICO	ペリコ
PELMAN	ペルマン
PENFIELD	ペンフィールド
PENKOVA	ペンコーワ
PENNINGTON	ペニントン
PENNY	ペニー
PENZLER	ペンズラー
PEPER	ペパー
PEPPING	ペッピング
PEPYS	ヒープス
PERCY	パーシー
PEREGO	ペレゴ
PERICLE	ペリクレ
PERLMUTTER	パールミュッター
PERSANO	ペルサーノ
PERSICHETTI	パーシケッティ
PERTILE	ペルティーレ
PERTZ	ペルツ
PESTALOZZI	ペスタロッチ
PETERBOROUGH	ピーターボロ
PETERFALVI	ペテルファルビ
PETITJEAN	プティジャン
PETREE	ペトリー
PETROGRAD	ペトログラード
PETROVA	ペトロワ
PETRUS	ペトルス
PEVSNER	ペブスナー
PEYROUZET	ペルゼ
PFENNING	プフェニング
PFORDTEN	プフォルテン
PHILIPSON	フィリプソン
PHILLPOTTS	フィルポッツ
PIANO	ピアノ
PIAZZA	ピアッツァ
PIC	ピック
PICK	ピック
PIDGEON	ピジョン
PIECHLER	ピーヒラー
PIERLUIGI	ピエールルイジ
PIETRANGELI	ピエトランジェリ
PIGNATEL	ピニャテール
PILON	ピロン
PINE	パイン
PINGET	パンジェ
PINKERTON	ピンカートン
PIOTTE	ピオット
PIRANI	ピラーニ
PIRQUET	ピルケ
PISCHEL	ピシェル
PITSKHELAURI	ピッツヘラウリ
PLANK	プランク
PLATTI	プラッティ
PLATTS	プラッツ
PLATZ	プラッツ
PLATZMAN	プラッツマン
PLOWDEN	プロードン
PLOWMAN	プラウマン
POGANY	ポガーニ
POLANYI	ポラニー
POLE	ポール
POLL	ポル
POLLAK	ポラック
PONCE	ポンセ
PONTORMO	ポントルモ
POPELKA	ポペルカ
PORT-OF-SPAIN	ポートオブスペイン
PORTEN	ポルテン
PORTZAMPARC	ポルザンパルク
POUGNET	プーニエ
POUGNY	プーニ
POULET	プーレ
POURBUS	プールビュス
POURTALES	プルタレース
POUTSMA	ポウツマ
POWICKE	パウイック
POWNALL	パウナル
POWYS	ポーイス
PRAED	プレード
PRAGUE	プラハ
PRANDTL	プラントル
PRATI	プラーティ
PRAUSE	プラウゼ
PRAUSS	プラウス
PREISENDANZ	プライゼンダンツ
PRESLEY	プレスリー
PRESTON	プレストン
PREWITT	プルウィット
PRIBILINEC	プリビリネツ
PRIMO	プリーモ
PRINZ	プリンツ
PRINZHORN	プリンツホルン
PROBST	プロプスト
PRONZATO	プロンザート
PROSSER	プロッサー
PROVINCETOWN	プロビンスタウン
PRYDE	プライド
PSALMANAZAR	サルマナザール
PTUSHKO	プトゥシコ
PUCHTA	プフタ
PUCK	パック
PUGACHYOV	プガチョーフ
PUGLISI	プリージ
PUNER	ピューナー
PURDY	パーディー
PURVIANCE	パービアンス
PURVITS	ピュルビツ
PUYANA	プヤーナ
PYLES	パイルズ
PYOTR	ピョートル
PYPIN	プイピン
QUADE	クエイド
QUERCIA	クェルチア
QUIDOR	キドール
QUINAULT	キノー
RADOSLAVOV	ラドスラーボフ
RADWANSKI	ラドワンスキー
RAHN	ラーン
RAIMOND	レモン
RAISA	ライザ
RAKHLIN	ラフリン
RAMIREZ	ラミレス
RANDOLF	ランドルフ
RANKL	ランケル
RAPIN	ラピン
RASP	ラスプ
RATHBONE	ラスボン
RATNER	ラトナー
RAUMER	ラウマー
RAUTAVAARA	ラウタバーラ
RAVEL	ラベル
RAVENSCROFT	レーベンスクロフト
RAVI	ラビ
RAY	ライ
RAYNAUD	レーノー
RAYNOUARD	レーヌアール
REAGAN	レーガン
REAVIS	レビス
REDFIELD	レッドフィールド
REDMOND	レドモンド
REDON	ルドン
REE	レー
REEVE	リーブ
REGAZZONI	レガツォーニ
REGER	レーガー
REHN	レーン
REICHENBERGER	ライヘンベルガー
REICHLEN	レシュレン
REIF	ライフ
REIL	ライル
REISS	レイス
REITER	ライター
REIZOV	レイゾフ
REM	レム
REMEZOV	レーメゾフ
RENAUD	ルノー
RENAUDET	ルノーデ
RENDANO	レンダーノ
RENOUVIN	ルヌーバン
RENOUX	ルヌー
RESHETIN	レシェティン
RESNIK	レズニック
RESPIGHI	レスピーギ
RETZ	レス
REVENTLOW	レーベントロー
REVERDY	ルベルディ
REX	レックス
REYNARDSON	レイナードソン
RHOADES	ロウズ
RHYNE	ライネ
RIBEIRO	リベイロ
RIBOT	リボー
RICHART	リチャード
RICHIE	リチー
RICKEN	ライケン
RIDDELL	リデル
RIDE	ライド
RIESMAN	リースマン
RIGAUD	リゴー
RIGAUT	リゴー
RIGBY	リグビー
RIGHTER	ライター
RINEHART	ラインハート
RISSANEN	リッサネン
RITZ	リッツ
ROALD	ロアルド
ROBARDS	ロバーズ
ROBINSON	ロバンソン
ROBUCHON	ロビュション
ROCKHILL	ロックヒル
RODAHL	ロダール
RODEN	ローデン
RODERICK	ロデリック
RODNEY	ロドニー
ROELANTS	ローランツ
ROESLER	レースラー
ROGIER	ロジエ
ROHRER	ローラー
ROLLE	ロル
ROLLESTON	ロレストン
ROMAN	ローマン
ROMERO	ロメロ
RONY	ローニ
ROOKE	ルーク
ROPEK	ロペック
ROSALIND	ロザリンド
ROSARIO	ロザリオ
ROSE	ロース
ROSENBUSCH	ローゼンブッシュ
ROSENGARTEN	ローゼンガーテン
ROSENSTEIN	ローゼンスタイン
ROSMAN	ロスマン
ROSOLINO	ロソリーノ
ROSSE	ロス
ROSTENKOWSKI	ロステンコウスキ
ROTA	ロータ
ROTTENHAMMER	ロッテンハンマー
ROUCEK	ローシェック
ROYER	ロワイエー
ROZA	ロザ
RUBINSHTEIN	ルビンシュテイン
RUBINSTEIN	ルビンスタイン
RUBNER	ルーブナー
RUBY	ルビー
RUCHT	ルフト
RUDD	ラッド
RUDIGER	ラディガー
RUPERT	ルーパート
RUSH	ラッシュ
RUTTNER	ルットナー
RUZICKA	ルツィカ
RYAZANOV	リャザーノフ
RYZHIK	リュジク
RZHANITSYN	ルジャニーツィン
SAALMAN	サールマン
SABOGAL	サボガル
SADOUL	サドゥール
SAGE	セージ
SAIDENBERG	サイデンバーグ
SAINT	セイント
SALE	セイル
SALIN	ザーリン
SALKELD	サルケルド
SALMON	サモン
SALOMON	ザロモン
SALTER	ソルター
SAMOILOVA	サモイロワ
SAMUELSSON	サムエルソン
SANCHO	サンチョ
SANDAY	サンデー
SANDBURG	サンドバーグ
SANDINO	サンディノ
SANDLER	サンドラー
SANDRO	サンドロ
SANKEY	サンキ
SANOTSKII	サノツキー
SANTANDER	サンタンデル
SAPIR	サピル
SARAH	サラー
SARAN	ザーラン
SARASIN	サラシン
SARBIEWSKI	サルビエフスキー
SARGENTI	サゲンティ
SARTON	サートン
SASDY	サスディ
SAUERBRUCH	ザウエルブルフ
SAUGUET	ソゲ
SAUVEUR	ソーブール
SAYERS	セイヤーズ
SCAMOZZI	スカモッツィ
SCARLETT	スカーレット
SCHEER	シェール
SCHEFFEL	シェッフェル
SCHEINER	シャイナー
SCHEINPFLUG	シャインプフルーク
SCHENK	シェンク
SCHERMERHORN	スヘルメルホルン
SCHIEFNER	シーフネル
SCHIELE	シーレ
SCHIFF	シフ
SCHIRRMACHER	シルマハー
SCHLAF	シュラーフ
SCHLAGINTWEIT	シュラーギントバイト
SCHLEH	シュレイ
SCHLOTE	シュローテ
SCHMALSTICH	シュマルシュティヒ
SCHMEIDEL	シュマイデル
SCHMID	シュミッド
SCHMIT	シュミット
SCHMITT	シュミット
SCHNACK	シュナック
SCHNECKENBURGER	シュネッケンブルガー
SCHNEE	シュネー
SCHNITTKER	シュニットカー
SCHOEBEL	ショーベル
SCHOEMAN	シェーマン
SCHOENAUER	ショウナワー
SCHOENFELD	ショーンフェルド
SCHOLL	ショール
SCHOPENHAUER	ショーペンハウアー
SCHOWALTER	ショーウォーター
SCHRAM	シュラム
SCHRAML	シュラムル
SCHRIEFFER	シュリーファー
SCHUB	シューブ
SCHUBART	シューバルト
SCHULKIND	シュルキンド
SCHULTZE	シュルツ
SCHWARZENBACH	シュワルツェンバッハ
SCHWARZER	シュバルツァー
SCHWARZKOPF	シュバルツコップ
SCHWEIGER	シュバイガー
SCHWEIZER	シュバイツァー
SCHWERDTNER	シュベルトナー
SCHWITTERS	シュウィッタース
SEAN	ショーン
SEARCY	サーシー
SEBBAR	セバー
SEBESTYEN	セベスティアン
SEBON	ゼーボン
SEDDON	セドン
SEGONZAC	スゴンザック
SEIBOU	セイブ
SEIGNER	セニエ
SEN	セン
SENANAYAKE	セナナヤケ
SERGI	サージ
SERTILLANGES	セルティヤンジュ
SEVERINI	セベリーニ
SEVERINSEN	セベリンセン
SEVERSKY	セバースキー
SEZNEC	セズネック
SHAIN	シャーイン
SHALLON	シャロン
SHALYAPIN	シャリアピン
SHANE	シェーン
SHANKAR	シャンカル
SHAPLAND	シャプランド
SHARETT	シャレット
SHCHELOKOV	シチェロコフ
SHEEAN	シーアン
SHEELER	シーラ
SHEENA	シーナ
SHEHU	シェーフ
SHEKHAR	シェカール
SHELTON	シェルトン
SHERBURNE	シャーバーン
SHERLEY	シャーリー
SHESTOPAL	シェストパール
SHLOMO	シュロモ
SHREVE	シュリーブ
SHRIVER	シュライバー
SHUFELDT	シューフェルト
SHUKHOV	シューホフ
SHULTS	シュルツ
SHURE	シュアー
SHUTKO	シュトコ
SHVETSOV	シベツォーフ
SIERPINSKI	シェルピンスキ
SIGOURNEY	シガニー
SIGRID	ジーグリット
SILKE	ジルケ
SILLIMAN	シリマン
SILVERT	シルバート
SIM	シム
SIMCOX	シムコクス
SIMMONDS	シモンズ
SIMROCK	ジムロック
SIMSON	ジムゾン
SINOPOLI	シノーポリ
SINOWATZ	ジノワツ
SITTE	ジッテ
SITTNER	ジットナー
SIWERTZ	シベルツ
SKELTON	スケルトン
SKILLMAN	スキルマン
SKOPJE	スコピエ
SKROWACZEWSKI	スクロバチェフスキ
SKRYABIN	スクリャービン
SKRZYPCZAK	スクリュプチャク
SKY	スカイ
SLAVEJKOV	スラベイコフ
SLAVICI	スラビチ
SLAYTON	スレイトン
SLIM	スリム
SLOVENIA	スロベニア
SMETANA	スメタナ
SMILLIE	スマイリー
SMITH	スミス
SMURA	スムラ
SMYTHSON	スマイズソン
SNEATH	スニース
SNEIDER	スナイダー
SNELSON	スネルソン
SOBELL	ソベル
SOBINOV	ソビノフ
SOBRERO	ソブレーロ
SOBRINO	ソブリノ
SOFFICI	ソッフィーチ
SOKOLOV	ソコロフ
SOLAL	ソラル
SOLE	ゾーレ
SOLMAN	ソルマン
SOLOMIN	ソローミン
SOLOMONS	ソロモン
SOLOVYOV	ソロビヨフ
SOMER	ゾマー
SOMERS	サマーズ
SOMMERFIELD	ソマーフィールド
SONNINO	ソンニーノ
SOOTHILL	スットヒル
SORAL	ソラル
SORBON	ソルボン
SOUFFLOT	スフロー
SOURDOUGH	サワードゥ
SOUTHALL	サウスオール
SOYER	ソイヤー
SOYINKA	ショインカ
SOZIN	ゾーチン
SPALDING	スポールティング
SPARGO	スパーゴ
SPEED	スピード
SPERRY	スペリー
SPETH	スペス
SPICER	スパイサー
SPIEGEL	スピーゲル
SPINK	スピンク
SPIRIN	スピーリン
SPITSYN	スピツイン
SPOFFORD	スポッフォード
SPRAT	スプラット
SPRENGER	シュプレンガー
SPRIGG	スプリッグ
SPROULL	スプロール
SPROUT	スプラウト
SPRUANCE	スプルーアンス
SPURGEON	スパージョン
SQUILLACE	スキラーチェ
STADER	シュターダー
STAFFAN	スタファン
STAMMLER	シュタムラー
STANGOS	スタンゴス
STANSFIELD	スタンズフィールド
STASOVA	スターソワ
STAUFFER	ストーフェール
STAUNING	シュタウニング
STEFAN	シュテファン
STEFANATO	ステファナート
STEGLICH	シュテークリヒ
STEHLE	シュテーレ
STEHLING	スティーリング
STEINGRUBER	シュタイングルーバー
STEINHARDT	スタインハート
STEINLE	シュタインレ
STEINTHAL	シュタインタール
STEPHANI	シュテファーニ
STERLING	スターリング
STERNE	スターン
STEURER	シュトイラー
STITT	スティット
STOCK	ストック
STOCKHAUSEN	シュトックハウゼン
STODOLA	ストドラ
STOKOWSKI	ストコフスキー
STONE	ストーン
STONEHENGE	ストーンヘンジ
STONIER	ストーニャー
STOWE	ストウ
STRACHAN	ストローン
STRAMIGIOLI	ストラミジョリ
STRANGE	ストレンジ
STRASZEWICZ	ストラシェビチ
STREFFER	ストレッファー
STREICH	シュトライヒ
STREITBERG	シュトライトベルク
STREVENS	ストレブンズ
STRIKE	ストライク
STROOF	シュトローフ
STROSS	シュトロース
STRUM	ストルム
STRUNK	ストランク
STUCLEY	スタクリー
STUNKARD	スタンカード
STURM	ステュルム
SUCHER	サッチャー
SUDAN	スーダン
SUDBURY	サドベリー
SUDHOF	ズートホフ
SUDREAU	シュードロー
SUGDEN	サグデン
SULEIMAN	スレイマン
SUMMERSON	サマーソン
SUNKEL	スンケル
SURMAN	サーマン
SURREY	サリー
SUSAN	スーザン
SUSANNAH	スザンナ
SUSANNE	ズザンヌ
SUTHERLAND	サザーランド
SUZAN	シュザン
SWEDENBORG	スウェデンボルグ
SWEENY	スウィーニー
SYLVAIN	シルバン
SYLVIA	シルビア
SYLVIO	シルビオ
SZAMOSI	サモシ
SZCZESNIAK	シチェスニアク
SZMIDT	シュミット
TABOR	タボール
TAILOR	テイラー
TALLAHASSEE	タラハシー
TAN	タン
TANIN	ターニン
TANNER	タネール
TANSKY	タンスキー
TAPPAN	タッパン
TARASENKO	タラセンコ
TARMO	タルモ
TASSINARI	タッシナーリ
TASSOPULOS	タッソプロス
TAUSINGER	タウジンガー
TAVIANI	タビアーニ
TAVRIZIAN	タブリジアン
TEAM	ティーム
TEKOAH	テコア
TELFORD	テルフォード
TEMES	テムズ
TENAILLE	トゥナイユ
TENNIEL	テニエル
TERRELL	テレル
TETENS	テーテンス
THADDEUS	タデウス
THAL	サール
THEILE	タイレ
THEO	セオ
THEUNIS	トゥニス
THOMSEN	トムセン
THOMTE	トムティー
THORNDIKE	トルンダイク
THORNLEY	ソーンレイ
THORSON	トーソン
THOU	トゥー
THRASHER	スラッシャー
THUILLIER	チュイリエ
TIEMPO	ティエンポ
TIFFIN	ティフィン
TILDEN	ティルデン
TILLER	ティラー
TILMAN	ティルマン
TINA	ティナ
TIZIANA	ティツィアーノ
TOA	トーア
TODT	トート
TOIVO	トイボ
TOKAR	トウカー
TOLLE	トリー
TOMAS	トマス
TONSON	トンソン
TOOMBS	トームス
TORRENS	トレンズ
TORRY	タリー
TOSCANELLI	トスカネリ
TOULET	トゥーレ
TOUREL	トゥーレル
TOURVILLE	トゥルビル
TOWER	タワー
TOWNS	タウンズ
TRAIKOV	トライコフ
TRAUBEL	トローベル
TRAUTWINE	トラウトワイン
TRAVERS	トラバーズ
TREGER	トレガー
TREITSCHKE	トライチュケ
TREXLER	トレクスラー
TRIFONOV	トリーフォノフ
TRIPOLI	トリポリ
TRYGVE	トリグベ
TSYGANOV	ツィガノフ
TUCK	タック
TUFFIER	テュフィエ
TUNIS	チュニス
TUNISIA	チュニジア
TURATI	トゥーラーティ
TURK	ターク
TURPIN	ターピン
TWARDOWSKI	トワルドーフスキー
TYNAN	タイナン
ULLMAN	ウルマン
UNNA	ウンナ
UNNERSTAD	ウンネルスタード
UPDIKE	アップダイク
URMILA	ウルミラ
URQUHART	アーカート
USHER	アッシャー
UWE	ウーベ
UZBEKISTAN	ウズベキスタン
VACHEK	バヘク
VAD	バート
VALASEK	バラセク
VALKOV	ボルコフ
VANCE	ヴァンス
VANDENBERG	バンデンバーグ
VANETTI	バネッティ
VANHECKE	バネック
VANZETTI	バンゼッティ
VARENIUS	ワレニウス
VARGAS	バーガス
VASARI	バサリ
VASCONCELLOS	バスコンセロス
VASCONCELOS	バスコンセロス
VASSOS	バッサス
VERDUN	ヴェルダン
VERE	ビアー
VERENDRYE	ベランドリー
VERHAEREN	ベルハアラン
VERI	ベリ
VERMIGLI	ウェルミーリ
VERROCCHIO	ベロッキョ
VERTOV	ベルトフ
VERWOERD	フルウールト
VESEY	ビージー
VEUILLOT	ブイヨ
VEVERS	ベバーズ
VICK	ビック
VICKERS	ビッカース
VICTORIAVILLE	ビクトリアヴィル
VIDA	ビーダ
VIEBIG	フィービヒ
VIGOLO	ビーゴロ
VILE	ビル
VILELA	ビレラ
VILLA	ビルラ
VILLARET	ビラレ
VILMORIN	ビルモラン
VINCENZO	ビンチェンツォ
VINES	バインズ
VINGE	ビンジ
VIRCHOW	ウィルヒョウ
VIRKKALA	ウィルッカラ
VISSCHER	フィッシェル
VISSER	フィセル
VOGLER	フォーグラー
VOLKONSKAYA	ボルコーンスカヤ
VOLKOV	ボルコフ
VOLTAIRE	ボルテール
VONDEL	フォンデル
VORONIN	ボローニン
WACKENRODER	ワッケンローダー
WAITZ	ワイツ
WAKELEY	ウェイクリー
WALESA	ワレサ
WALLACH	ウォラック
WALLIN	ワーリン
WALLINGTON	ウォーリントン
WALLIS	ウォリス
WALSHE	ウォールシュ
WALTER	ワァルター
WALZEL	ワルツェル
WAND	バント
WANGERIN	ワンジェリン
WARBECK	ウォーベック
WARMING	ワルミング
WARN	ウォーン
WARREN	ワレン
WARTON	ウォートン
WASLEY	ウォズレイ
WASSON	ワッソン
WATKINS	ワトキンス
WATT	ワット
WAUCHOPE	ウォーカップ
WAUGH	ウォー
WAY	ウェー
WAYLAND	ウェイランド
WEATHERILL	ウェザリル
WEATHERS	ウェザーズ
WEENIX	ウェーニクス
WEILENMANN	バイレンマン
WEIMANN	バイマン
WEINBRENNER	ワインブレンナー
WEINHEBER	ワインヘーバー
WEINRICH	ワインリヒ
WEISKOPF	ワイスコフ
WEISMANTEL	ワイスマンテル
WEISZ	ワイス
WEITS	ワイツ
WENIG	ベニヒ
WERNICK	ワーニック
WESTERGREN	ウェステルレイン
WESTMORELAND	ウェストモーランド
WESTON	ウェストン
WEXLER	ウェクスラー
WEYRAUCH	ワイラウフ
WHEATER	ホイーター
WHEELER	ホイラー
WHERRY	ウェリィ
WHITING	ホワイティング
WHITLAM	ホイットラム
WIARDA	ウィーアルダ
WICHEREK	ウィヘレク
WIEBER	ウィーバー
WIECHERT	ウィーヘルト
WIEDEMANN	ウィーデマン
WIEGNER	ウィーグナー
WIEMER	ウィーマー
WIESMEIER	ビースマイアー
WIGHTMAN	ワイトマン
WILKS	ウイルクス
WILLIE	ウィリー
WILLISTON	ウィリストン
WILLM	ウェルム
WILLMAN	ウィルマン
WILLOUGHBY	ウィロビ
WILTSHIRE	ウィルトシャー
WIMMER	ウィンマー
WINDHEIM	ウィンドハイム
WINES	ワインズ
WINGS	ウィングズ
WINKELMAN	ウィンケルマン
WINN	ウィン
WINSTON	ウィンストン
WINTRINGHAM	ウィントリンガム
WIRTHLIN	ウィルスリン
WISHART	ウィシャート
WISNIEWSKA	ウィスニエフスカ
WISSEL	ウイッセル
WITHERSPOON	ウィザースプーン
WITKE	ウィトケ
WITNESS	ウイットネス
WITTELSBACH	ウィッテルスバッハ
WITTEVEEN	ウィッテフェーン
WITTGENSTEIN	ウィトゲンシュタイン
WITTLIN	ウィトリン
WOESTE	ウースト
WOFFINGTON	ウォフィングトン
WOLD	ウォルデ
WOLE	ウォーレ
WOLFORD	ウルフォード
WOLFSTHAL	ウォルフスタール
WOLKE	ウォルケ
WOODIN	ウッドン
WOODS	ウーズ
WOOLDRIDGE	ウイドリッジ
WOOLLAM	ウォーラム
WOOLNER	ウルナー
WORDSWORTH	ワーズワス
WORM	ウォルム
WORSLEY	ワースレイ
WORTIS	ウォルティス
WUCHERPFENNIG	ウーハーペニヒ
WURZBACH	ブュルツバッハ
WYLER	ワイラー
WYMER	ワイマー
WYNDHAM	ウインダム
WYNNE	ワイン
WYNTER	ウィンター
XENOPHON	クセノフォン
YABLONSKY	ヤブロンスキー
YAHYA	ヤヒヤ
YANES	ヤーネス
YANKELOVICH	ヤンケロビッチ
YANSHIN	ヤンシン
YAZDI	ヤズディ
YEOMAN	ヨーマン
YOGI	ヨーギ
YORKTOWN	ヨークタウン
YOULOU	ユール
YURENEV	ユレーネフ
ZABLOCKI	サブロッキ
ZACHARIADES	ザカリアデス
ZAHEDI	ザーヘディー
ZANDIN	サンディン
ZANE	ゼーン
ZANNINI	ザンニーニ
ZARB	ザーブ
ZAUN	ツァウン
ZDENEK	ズデネク
ZECKENDORF	ゼッケンドルフ
ZEFFIRELLI	ゼフィレッリ
ZELENKA	ゼレンカ
ZENATELLO	ゼナテルロ
ZENGER	ゼンガー
ZHEBELYOV	ジェベリョーフ
ZHELEZNIKOV	ジェレーズニコフ
ZHISLIN	ジスリン
ZINK	ツィンク
ZINZENDORF	ツィンツェンドルフ
ZOLLER	ゾラー
ZORRILLA	ソリーリャ
ZORZA	ゾルザ
ZOSHCHENKO	ゾシチェンコ
ZUBIRI	スビリ
ZURLINI	ズルリーニ
ZVORYKIN	ズボルィキン
ZWERGER	ツベルガー
